Human Resources / Personnel Commissioner	recruitment,br,orientation,fair,advertisement,related,statistical,campus,staff,affairs
高级(资深)销售代表/客户经理(主任)/销售代表	客户,br,销售,负责,工作,维护,公司,产品,开发,完成
讲师/助教	学生,br,课程,教学,工作,负责,教师,担任,英语,助教
培训专员/助理	培训,br,员工,工作,负责,课程,管理,协助,入职,组织
总工程师/副总工程师	br,负责,工艺,产品,设计,技术,生产,工作,制定,管理
律师助理	律师,br,案件,协助,法律文书,工作,诉讼,法律,整理,当事人
人力资源/人事专员	br,员工,招聘,负责,工作,考勤,入职,培训,办理,公司
高级软件工程师	br,开发,项目,系统,负责,工作,设计,模块,软件,平台
part-time staff	Shop,Assistant,Cashier,Volunteered,Provided,customers,busy,service,sometimes,pressure
基金经理	br,投资,项目,管理,参与,研究,基金,行业,尽职,分析
行政专员/助理	br,工作,负责,考勤,公司,管理,协助,员工,办公用品,日常
医药销售经理/主管	br,负责,销售,开发,工作,医院,市场,管理,维护,客户
工程造价师/预结算	结算,工程,br,工作,负责,项目,预算,编制,审核,工程量
服装设计/打样/制版	设计,款式,服装,br,设计师,工作,面辅料,面料,样衣,流行
网络信息安全工程师	br,网络,维护,负责,服务器,系统,安全,公司,运维,工作
供应链经理/主管/专员	br,采购,供应商,物料,管理,负责,工作,库存,计划,供应链
市场研究统计/分析	分析,工作,负责,br,客户,公司,职责,数据,策划,运营
审计专员/助理	审计,底稿,br,审计工作,工作,审计报告,协助,负责,编制,完成
麻醉医生	麻醉,工作,椎管,神经,独立,医院,职位,阻滞,进修,无痛
嵌入式系统软件开发(单片机·DLC·DSP)	br,开发,编写,负责,单片机,调试,设计,工作,软件,驱动
营运经理	br,生产,管理,工作,负责,计划,员工,质量,组织,公司
海关事务管理	报关,br,海关,负责,进出口,商检,货物,进口,核销,报检
建筑工程师	施工,br,工作,负责,项目,现场,工程,技术,设计,管理
牙科医生	事务,口腔科,接诊,负责,所有,独立,患者,医院,各项,操作
医药代表	销售,br,负责,医院,客户,工作,维护,公司,推广,产品
cable transmission engineer	development,Product,assembly,br,Cable,process,problems,production,design,components
机械维修工程师	设备,维修,维护,负责,保养,br,工作,调试,安装,主要
施工员	施工,现场,放线,负责,工作,管理,测量,br,工程,施工员
项目专员	br,负责,项目,工作,客户,管理,施工,协助,现场,工程
空乘人员	乘务员,空中,br,沟通,SERVICE,处理,世界,海航,10,航班
美术编辑/美术设计	设计,负责,br,制作,工作,网站,排版,公司,主要,游戏
Business Manager / Business competent	customer,signing,tendering,direct,export,reports,surveys,review,two,charge
客户服务专员/助理	客户,br,负责,工作,客服,处理,销售,投诉,沟通,公司
渠道/分销主管	br,销售,负责,工作,客户,渠道,管理,维护,区域,公司
Sales Engineer	br,sales,new,customers,relationship,company,customer,09,reference,visit
project Commissioner	br,production,requests,relevant,scan,into,related,sources,design,visualization
汽车机构工程师	br,工作,设计,工艺,开发,产品,负责,结构设计,车身,参与
系统管理员/网络管理员	维护,br,网络,服务器,负责,公司,管理,系统,工作,日常
电信网络工程师	网络,负责,br,维护,工作,设备,安装,客户,机房,交换机
Financial Analyst	br,team,Group,within,Collaborated,financial,cost,accounting,statements,standards
market / planning competent	br,planning,promotional,quot,promotion,media,cost,sales,design,responsible
电话销售	客户,电话,销售,br,公司,通过,工作,负责,沟通,产品
家教	学生,辅导,家教,英语,成绩,数学,小学,br,学习,教学
Marketing Planning / Planning	Responsible,sales,MKT,analysis,registration,research,organizing,market,telecommunication,management
客户经理/金融产品营销管理	客户,br,业务,负责,工作,维护,营销,客户经理,理财,开发
工程/设备管理	设备,br,负责,管理,维修,维护,工作,保养,生产,调试
硬件测试	测试,br,负责,工作,产品,维护,维修,组装,硬件,检测
document engineer	website,web,working,Information,company,clients,Edong,Research,Assisted,other
律师	br,法律,律师,诉讼,案件,代理,工作,法律顾问,合同,纠纷
品质经理	br,测试,质量,工作,负责,项目,产品,测试用例,公司,测试计划
FAE现场应用工程师	br,客户,产品,测试,进行,技术支持,负责,销售,不良,改善
业务拓展(BD)总监/经理	br,客户,负责,工作,销售,拓展,业务,公司,维护,开发
造型设计	设计,负责,br,造型,产品,工作,主要,进行,制作,外观
展示/装潢/展览设计	设计,施工图,设计师,效果图,客户,工作,br,负责,绘制,施工
保险代理/经纪人/客户经理	客户,保险,销售,br,工作,电话,负责,培训,沟通,维护
ERP implementation of consultants	user,br,training,set,process,some,module,BOM,tools,PP
理疗/营养师	客户,健康,br,工作,营养,指导,协助,负责,回访,培训
销售总监	br,销售,负责,客户,团队,公司,工作,管理,营销,制定
大/小烫	期间,带条,外发部,虽然,499,性质,私营,按期,手针,同事
配色技术员	配方,客户,br,负责,配色,修色,主要,ISO14000,施工,小样
financial officer / general ledger assistant	financial,tax,br,work,accounting,monthly,system,Prepare,Verify,cost
Sales Director	warranty,sector,Develop,sales,proven,promotional,rate,agents,year,quality
调度员	车辆,br,负责,调度,工作,运输,货物,物流,公司,管理
中医科医生	br,中医,日常,病人,治疗,患者,工作,针灸,主任,拔罐
调研员	br,调查,问卷,工作,负责,撰写,项目,报告,客户,调研
物业管理经理/主管	工作,br,负责,管理,物业,物业管理,制定,业主,部门,员工
Customer Service Manager / supervisor	br,up,sales,HK,operation,system,inventory,upon,request,team
Foreign Trade / Trade Commissioner / Assistant	br,customers,up,production,visit,work,time,products,sales,orders
标准化工程师	br,负责,项目,开发,工作,需求,编写,模块,客户,文档
面料/辅料/图案设计	设计,br,主要,图案,工作,负责,要求,工艺,客户,花型
product development or technology / process design manager	development,validation,maintenance,process,blasting,work,well,system,research,project
客户服务总监	br,客户,工作,负责,团队,管理,服务,客服,流程,呼叫
生产主管/督导/组长/领班	生产,br,负责,管理,工作,车间,员工,人员,现场,培训
财务总监	br,财务,公司,工作,负责,财务管理,管理,税务,预算,组织
市场/企划总监	br,负责,品牌,策划,公司,工作,制定,推广,营销,销售
市场/企划主管	br,负责,策划,推广,活动,工作,公司,市场,销售,制定
总监·事业部总经理	br,负责,工作,管理,公司,项目,销售,制定,团队,运营
interns	br,my,sales,team,members,work,solutions,superior,writing,main
小学教师	小学,教学,学生,工作,语文,教师,班主任,br,英语,负责
Production Supervisor / supervisor / team leader / foreman	br,production,quality,management,product,plan,products,system,work,time
咨询总监/项目经理	br,项目,咨询,企业,管理,客户,负责,培训,公司,规划
理财顾问/财务规划师	客户,br,培训,理财,销售,公司,工作,主要,团队,营销
Quality Management (QA) / quality control (QC)	quality,br,supplier,product,work,production,report,new,customer,up
Chief Executive Officer (CEO) / President / Executive Director / general manager	br,Management,Develop,trend,some,factory,planning,our,out,what
others	br,sales,team,training,support,review,business,work,product,planning
Procurement Management	br,suppliers,product,purchasing,supplier,control,cost,track,tool,purchase
融资总监	br,负责,融资,项目,团队,公司,集团,投资,工作,风控
招聘经理/主管	招聘,br,工作,员工,负责,公司,培训,面试,入职,人员
仓库管理员	仓库,br,负责,盘点,工作,物料,管理,入库,货物,出库
作家/撰稿人/专栏	br,撰写,策划,工作,编辑,稿件,完成,签约,杂志,文案
资产管理/交易管理/资金管理/财务管理	br,负责,项目,管理,工作,公司,投资,客户,交易,分析
音频/视频工程师/技术员	br,调试,负责,开发,维护,程序,编写,现场,维修,组合音响
机电工程师	br,设备,工作,负责,维修,调试,设计,安装,维护,现场
warehouse manager / supervisor	customer,do,good,help,Service,give,work,solution,batteries,reasonable
supply chain manager / supervisor / Commissioner	br,logistics,supply,supplier,quality,purchasing,production,suppliers,work,project
物流专员/助理	br,货物,物流,负责,客户,工作,管理,发货,仓库,处理
药库主任/药剂师	药品,管理,工作,处方,负责,发药,调剂,发放,日常,进行
university professor	lectures,educational,br,business,established,students,Denmark,Give,School,cooperation
Structural Engineer	pre,selection,tCarried,stacking,supported,prototyping,production,design,zinc,shooting
前台/总机/接待	负责,br,接待,工作,前台,收发,考勤,客户,办公用品,来访
electrical engineer / technician	br,testing,test,power,design,commissioning,turbine,technology,equipment,installation
运输经理/主管	br,负责,物流,工作,管理,运输,客户,调度,车辆,车队
科研管理人员	负责,br,工作,产品,管理,研发,协助,维护,检验,流程
建筑工程验收	验收,工程,工作,负责,施工,质量,资料,现场,br,进行
进出口/信用证结算	br,信用证,客户,业务,国际,结算,工作,融资,处理,单证
保险内勤	br,工作,负责,客户,业务,培训,协助,管理,日常,保险
汽车安全性能工程师	br,汽车,试验,分析,安全,开发,客户,整车,碰撞,PV
项目管理	br,项目,负责,工作,管理,公司,客户,职位,团队,施工
电子商务	br,负责,客户,推广,工作,淘宝,产品,销售,店铺,网站
日语翻译	翻译,br,工作,日本,负责,客户,日语,口译,邮件,资料
Account Manager / Financial Product Marketing Management	familiar,br,financial,process,sales,private,trade,manager,settlement,staff
策略计划	策划,br,活动,工作,负责,客户,方案,执行,撰写,推广
货运代理	br,客户,货物,负责,报关,订舱,操作,单证,业务,工作
会计经理/主管	br,负责,工作,财务,公司,账务,审核,报表,编制,核算
印刷排版/制版	排版,负责,印刷,设计,br,工作,客户,印前,修改,制作
行政经理/主管/办公室主任	br,工作,负责,公司,管理,行政,员工,日常,考勤,部门
光源与照明工程	生产,br,研发,工作,电气,负责,灯具,施工,管理,技术
drainage / strong or weak electrical / refrigeration HVAC	preembedded,electric,power,involved,site,water,Became,drawings,assistant,engineer
医药检验	工作,检验,br,检验科,负责,实习,药品,常规,实验,仪器
物料主管/专员	物料,br,负责,工作,管理,计划,生产,盘点,采购,ERP
广告创意/设计	设计,负责,工作,br,制作,客户,广告,平面设计,主要,公司
finance manager / director / Commissioner	core,financing,funding,risk,implementation,measures,analysis,member,rate,br
多媒体/动画/3D设计	制作,动画,负责,br,场景,设计,工作,模型,项目,3D
文案/策划	策划,br,负责,文案,撰写,活动,工作,推广,公司,客户
总编/副总编/主编	br,策划,负责,杂志,选题,工作,编辑,撰写,公司,流程
知识产权/专利顾问/专员	br,专利,知识产权,撰写,负责,专利申请,商标,客户,工作,文件
合伙人	br,负责,公司,工作,管理,销售,客户,运营,培训,创业
列车车长	严谨,保证,列车长,旅途,职业生涯,事项,工作作风,以及,沈阳,京沪
product manager / supervisor	core,network,technology,trend,communication,system,virtual,research,products,br
automotive design engineer	tHandle,customers,requirements,tResponsible,series,support,system,design,solutions,br
电池/电源开发	br,电池,负责,设计,测试,研发,项目,生产,开发,电源
临床试验/药品注册	br,启动,项目,工作,研究,试验,如下,合同,中心,肿瘤
项目主管	br,负责,项目,工作,管理,施工,工程,协调,现场,客户
公关总监/经理	br,公关,工作,负责,品牌,媒体,客户,公关活动,传播,推广
项目总监	br,项目,负责,工作,工程,管理,协调,设计,监理,公司
human resources / personnel managers	br,status,help,site,according,recruitment,reports,questions,Conduct,Employee
project officer	control,organize,saving,process,factory,upgrade,working,system,writing,equipment
asset evaluation / analysis	SZ,Co,assets,appraisal,work,value,years,field,accomplished,br
institutions, Senate manager	recruitment,result,our,coordination,universities,different,management,personnel,strictly,responsible
培训总监/经理/主管	培训,br,员工,负责,课程,工作,公司,管理,讲师,组织
技术研发经理/主管	br,设计,产品,工作,负责,研发,技术,工艺,测试,项目
mechanical engineer	br,design,processing,technical,workshop,project,process,equipment,parts,device
医疗器械销售/市场推广	br,销售,负责,产品,工作,医院,客户,医疗器械,主要,培训
司机	负责,司机,工作,接送,公司,领导,车辆,用车,开车,br
ERP技术开发	br,ERP,开发,维护,SAP,系统,工作,二次开发,项目,负责
brand / product manager	br,product,sales,market,marketing,amp,technical,seasonal,set,Responsible
厂长/副厂长	生产,br,负责,管理,工作,工厂,公司,计划,设备,部门
法律顾问	公司,法律,br,合同,负责,起草,法律事务,工作,审核,诉讼
培训生	br,培训,学习,工作,实习,负责,项目,了解,开发,进行
生产计划/仓库/物料管理	生产,br,计划,物料,负责,订单,工作,仓库,管理,进度
market / Planning Director	channel,marketing,br,Develop,communication,manage,sales,planning,departmental,PR
外贸/贸易经理/主管	br,客户,负责,工作,订单,外贸,展会,公司,产品,销售
内科/外科/专科医生医师	工作,内科,br,治疗,手术,常见病,科室,外科,医师,病人
防损/内保	工作,负责,消防,消防安全,br,主要,安全,员工,卖场,培训
产品开发或技术/工艺设计经理	br,产品,负责,设计,工作,工艺,生产,研发,模具,开发
Industry (IE) engineers	Process,plant,kinds,generator,power,technical,lot,system,Improvement,owner
摩托车工程师	br,零部件,开发,设计,工作,负责,售后,产品质量,整车,装配
UI设计师/工程师	设计,br,负责,UI,页面,网站,产品,制作,工作,交互
质量检验员/测试员	检验,br,负责,工作,产品,检测,质量,生产,成品,进行
Office Representative	br,BAP,DRP,burners,within,results,existing,teams,quality,sell
裁剪车缝熨烫	是从,样衣,利用,时间,初三,缝合,服装,缝制,样品,检修
汽车销售/经纪人	销售,客户,汽车,接待,负责,br,工作,车辆,满意度,顾问
情报信息分析	br,撰写,分析,客户,信息,报告,数据分析,负责,数据,项目
乘务员/售票员	旅客,工作,负责,br,服务,乘务员,卫生,乘客,售票,领导
认证工程师/审核员	br,认证,负责,客户,工作,测试,体系,CCC,文件,审核
电镀工	负责,维护,生产,电镀,调试,保养,设备,安排,日常,表面
工程/机械绘图员	设计,图纸,br,绘制,负责,工作,产品,CAD,主要,工艺
Network Engineer	wide,management,network,area,implementation,when,wiring,project,planning,maintenance
售前支持工程师	br,客户,售前,产品,工作,负责,技术支持,项目,方案,销售
光源与照明工程师	br,LED,设计,产品,开发,照明,电源,负责,灯具,光源
false	青海,处理,四川,验收,利用,炼钢,湖北,信函,食品,俄语
税务经理/主管	br,税务,申报,负责,纳税,工作,企业,公司,发票,涉税
文档工程师	br,文档,编写,项目,工作,软件,手册,参与,产品,负责
工程项目经理/主管	br,负责,生产,管理,产品,项目,工作,设备,工艺,调试
生物工程/生物制药	br,工作,负责,生产,纯化,检测,实验,车间,实验室,发酵
brand / product managers	product,tactics,ways,marketing,sales,analysis,up,rules,survery,br
增值产品开发工程师	br,负责,开发,电信,测试,分析,定位,出差,牵引,Media
Requirement engineers	business,requirements,system,customer,operations,Management,sales,within,System,helped
食品机械	设备,调试,机器,进行,负责,维修,生产,装配,非标,br
锯床/车床/磨床/铣床/冲床/锣床	加工,操作,工作,零件,车床,数控,主要,调试,车工,编程
手袋设计师	设计,手袋,品牌,产品,产品设计,工作,相关,真皮,定板,大方向
宠物医生/宠物护理	宠物,负责,造型,洗澡,宠物用品,考勤,工作,采购,主人,日常
系统集成工程师	br,项目,负责,工作,系统,维护,网络,安装,调试,服务器
电子软件开发	br,单片机,开发,软件,负责,调试,编写,硬件,工作,主要
化学分析测试员	检测,br,负责,工作,分析,仪器,检验,主要,成品,样品
员工关系/企业文化	br,员工,工作,负责,企业,公司,文化,策划,活动,内刊
皮衣/裘衣设计	开始,衣服,处理,程序,参与,污渍,中间,不同,质检,制作
融资经理/主管/专员	br,融资,负责,工作,客户,业务,项目,银行,贷款,公司
Reception / etiquette / operator	website,them,would,same,route,pick,up,us,guests,they
供应商管理	供应商,br,采购,物料,负责,品质,管理,处理,工作,评估
服装/纺织/皮革跟单	br,生产,大货,跟进,客户,跟单,工厂,订单,负责,进度
石油天然气仓储运输	安全,br,行车,车容,交通法规,车辆,整洁,运输,调度,天然气
销售助理/销售行政助理	销售,br,客户,负责,工作,协助,产品,订单,公司,沟通
需求工程师	br,需求,负责,系统,项目,工作,客户,产品,分析,文档
Business Assistant	customer,affairs,such,..,business,taking,sundry,up,etc,solve
软件工程师	开发,br,负责,项目,模块,工作,编写,系统,设计,维护
senior business / business follow-up	new,up,order,sample,through,orders,br,production,work,time
安全/健康/环境管理	安全,br,负责,工作,管理,公司,培训,职业,EHS,组织
化工技术应用	工艺,br,生产,负责,车间,操作,设备,工作,工艺流程,实习
迎宾/行李员	酒店,客人,工作,服务,负责,接待,行李,br,前台,介绍
外贸/贸易专员/助理	客户,br,负责,订单,工作,外贸,产品,询盘,阿里巴巴,出货
Chief Commissioner / Assistant	br,company,Responsible,meeting,work,staff,report,timely,summary,HR
船舶工程师	船舶,工作,设备,负责,br,设计,施工,冰机,空压机,油机
项目经理	br,项目,负责,工作,管理,施工,项目经理,工程,进度,客户
headhunting consultant / assistant	Responsibility,Search,right,interprise,Recommend,Mainly,foreign,famous,client,candidates
人力资源/人事总监	br,人力资源,公司,工作,员工,管理,培训,负责,组织,人力
电气工程师/技术员	调试,br,电气,工作,负责,设备,设计,PLC,安装,维护
媒介(企划)总监	br,媒体,策划,工作,客户,负责,推广,公司,微信,制作
猎头顾问/助理	br,候选人,客户,面试,职位,招聘,简历,人才,沟通,寻访
技术支持经理	br,负责,工作,客户,技术支持,技术,产品,售前,系统,公司
物流经理/主管	br,物流,管理,工作,负责,仓库,部门,公司,客户,配送
美术指导	br,设计,公司,工作,职责,全职,创意,性质,服务,物料
投资银行业务	br,项目,尽职,投资,负责,工作,企业,参与,IPO,协助
insurance checker	underwrite,product,materials,amp,translate,insurance
制造工程师	br,工艺,生产,工作,负责,产品,设计,制程,模具,加工
Industrial / Product Design	br,design,set,sanding,down,performance,motor,tMotor,quality,unit
统计	统计,br,负责,工作,报表,数据,核算,销售,生产,核对
故障分析工程师	br,分析,设备,维修,故障,负责,流程,不良,生产线,导入
客户培训	培训,br,客户,工作,负责,销售,员工,进行,产品,知识
汽车/摩托车工程师	设计,br,项目,摩托车,工作,负责,处理,数模,进度,以及
技术文员/助理	br,负责,工作,维护,客户,软件,管理,公司,协助,整理
包装设计	包装,设计,负责,产品,br,公司,工作,制作,客户,打样
精密机械/仪器仪表工程师/技术员	仪表,br,维护,工作,调试,负责,安装,设备,现场,主要
财务分析员	br,分析,预算,财务,负责,报表,编制,报告,公司,数据
laboratory research staff	IoT,splitting,hosted,electrode,network,quot,hydrogen,Participated,research,application
director, general manager	br,up,individually,Hong,set,financial,发烧,萨菲,飞洒,within
IC IC design / application engineer	simulation,design,Management,sige,reference,manual,amp,DC,vim,topic
媒介主任/专员	br,媒体,策划,工作,微博,负责,客户,推广,管理,活动
信息技术专员	br,维护,负责,工作,系统,公司,管理,网络,服务器,软件
营养师	br,工作,流程,65,一些,第一手,文职,经验,制备,静冈县
after-sales support engineers	br,problems,key,process,customers,service,support,production,so,development
语音/视频开发工程师	br,视频,算法,负责,文档,工作,镜头,matlab,编解码,技术
自动控制工程师/技术员	调试,br,PLC,设备,负责,自动化,设计,电气,工作,安装
systems analyst / Architect	br,design,system,development,repositories,Responsible,sales,integration,solutions,Include
收银员	收银,工作,负责,收银员,顾客,br,前台,主要,客人,结账
project engineer	related,br,technical,work,project,client,process,manage,years,Environment
导购/促销员	销售,负责,顾客,工作,br,产品,促销,促销员,商品,主要
服装/纺织设计	br,设计,面辅料,款式,样衣,面料,工作,设计师,跟进,服装
shipping / air / land transport	br,sales,vessel,tNegotiate,purchasing,freight,touch,operation,vsl,voyage
药品注册	资料,翻译,FDA,药理学,EDMF,emea,临床试验,CTD,致癌性,毒性
高级业务/业务跟单	br,客户,订单,跟进,负责,出货,工作,生产,跟单,工厂
人力资源/人事助理	br,员工,招聘,负责,工作,考勤,入职,协助,办理,培训
咨询员	br,客户,咨询,负责,工作,项目,主要,公司,撰写,沟通
机绣工/撕纸朴/压线	加工,任务,保证,如果,进行,以前,棉花,车缝,拿下,生产
调度员/站务/行调员	工作,负责,br,车辆,协调,生产,车站,调度,沟通,合理
纸浆/造纸	纸机,协调,生产,DCS,制造,控制,材料,车间主任,协助,做事
technical support engineers	br,support,team,system,products,software,problem,server,somebody,resolve
Accountant	br,tax,accounting,set,financial,yearly,Prepare,company,my,process
production manager / director of the workshop	br,production,system,team,quality,management,work,process,improve,training
保险业务经理/主管	团队,br,销售,客户,负责,业务,工作,管理,培训,保险
project manager	br,team,project,projects,management,test,amp,report,marketing,technical
经理助理/秘书/文员	br,工作,负责,协助,公司,考勤,日常,文件,管理,部门
recruitment manager / supervisor	Responsible,relationship,tunnel,company,work,Department,contract,sign,timing,recruitment
电子工程师/技术员	br,产品,调试,负责,测试,工作,PCB,维修,设计,生产
客户咨询热线·呼叫中心人员	客户,负责,br,接听,投诉,工作,电话,客服,业务,咨询
市场调研/分析	br,负责,分析,客户,工作,市场,调查,项目,调研,市场调研
品牌/产品总监	br,负责,品牌,策划,产品,工作,管理,销售,营销,推广
导游/旅游顾问	导游,旅游,游客,负责,br,工作,接待,讲解,旅行社,安排
semiconductor engineer	statistical,parameters,process,yield,than,production,products,per,br,team
板房/楦头/底格出格师	沟通,样板,工作,图纸,样卡,供应商,剪样,一丝不苟,洗水及,纸样
楼面经理	br,工作,负责,管理,员工,培训,餐厅,日常,部门,人员
院校教务管理人员	工作,br,负责,学生,教学,管理,教务,教师,招生,课程
电子/电器维修工程师/技师	维修,工作,负责,br,产品,调试,不良,测试,主要,分析
Documentation Staff/ declaration drafter	required,process,into,forwarders,tax,related,freight,information,lead,rebate
产品/生产工艺(PE)工程师	br,工艺,产品,生产,负责,工作,工装,制程,设计,改善
市场研究总监/副总监	撰写,工作,负责,br,分析,展示,建设,策划,咨询,可耐福
网站/产品策划	br,网站,负责,产品,策划,工作,设计,用户,需求,运营
procurement director	br,up,two,computer,participate,weekly,management,consortium,reduction,proposal
Accounting Manager / director	operations,control,relevant,office,tax,month,reports,end,prepare,credit
系统工程师	br,维护,系统,工作,服务器,负责,开发,项目,数据库,监控
Finance / Accounting Assistant	cash,br,control,financial,successfully,Excel,Ledger,manager,cost,through
logistics manager / supervisor	br,production,daily,logistics,tPreparation,communication,price,tOrganized,export,shipping
保险精算师	精算,协助,定价,br,车险,建模,公司,录入,报告,产品
Site Operations Manager / supervisor	br,relevant,supported,segmentation,related,maitenance,malls,web,use,support
保险客户服务/续期管理	客户,保险,br,负责,销售,电话,工作,公司,服务,培训
环境管理/环境保护	br,工作,负责,污水,处理,调试,污水处理,项目,运行,环保
焊接工程师/技师	焊接,工艺,br,负责,编制,工作,焊工,评定,车间,技术
Software Testing	br,test,back,close,Run,deliver,tools,fed,was,cases
审计经理/主管	审计,br,工作,审计工作,负责,项目,公司,审计报告,财务,内控
设备工程师	br,负责,工作,设备,施工,给排水,图纸,安装,验收,管理
销售培训师	培训,br,销售,负责,工作,客户,公司,员工,课程,产品
家用电器/数码产品研发	br,负责,产品,设计,开发,硬件,调试,测试,工程师,工作
market research / analysis	fidelio,forecasting,plans,trend,marketing,site,drafting,translating,other,systems
director / deputy director	operations,terms,basis,monthly,review,planning,master,br,meet,scheduling
档案管理	档案,工作,整理,负责,br,资料,归档,管理,档案管理,录入
设计管理人员	设计,br,负责,工作,制作,客户,公司,产品,宣传,平面设计
apparel / textile / leather engineer	washing,garment,up,trade,production,samples,follow,amp,technology,them
engineering / equipment management	br,equipment,production,maintenance,line,training,installation,system,up,new
researcher	br,through,program,using,experiments,Designed,communication,wireless,process,problems
清算/结算	br,工作,负责,结算,客户,业务,银行,清算,审核,实习
副店长/助理店长	br,工作,管理,员工,负责,销售,店长,培训,餐厅,人员
国内贸易人员	客户,br,负责,工作,订单,跟进,销售,出货,采购,公司
空调/热能工程师	设计,br,工作,负责,空调,系统,施工,图纸,项目,设备
移动通信工程师	br,工作,负责,优化,维护,测试,移动,网络,设备,LTE
财务经理	br,财务,工作,负责,公司,税务,管理,财务管理,核算,报表
生产文员	生产,br,负责,工作,考勤,报表,员工,协助,车间,统计
branch manager /office manager	br,new,Management,office,optimizing,customers,Brach,Responsibilities,service,targets
保险理赔	理赔,br,定损,查勘,出险,工作,负责,客户,案件,保险
校对/录入	校对,工作,负责,进行,br,编辑,排版,录入,书稿,图书
物业维修/维护人员	维护,负责,维修,工作,设备,保养,系统,主要,br,管理
测试工程师	测试,br,负责,产品,工作,测试用例,调试,编写,测试报告,进行
Business Development (BD) Director / Manager	br,business,company,USA,sales,market,customers,project,development,developed
媒介总监/经理	br,媒体,策划,制定,宣传,媒介,负责,传播,品牌,推广
水利/水电工程师	br,施工,工作,负责,设计,工程,图纸,技术,调试,管理
仿真应用工程师	制造,法线,效果显著,散热,插齿,RMB800,场景,类别,FLIR,3D
渠道/通路经理	br,负责,渠道,工作,销售,客户,市场,管理,推广,维护
订票/订房服务	预订,负责,工作,机票,酒店,预定,br,客人,处理,订房
客户经理	br,客户,负责,工作,项目,执行,策划,广告,活动,维护
Purchaser / Assistant	br,supplier,suppliers,parts,new,management,price,time,material,team
Production Planning / warehouse / materials management	br,responsibilities,production,planning,new,main,plan,resources,product,schedule
工业/产品设计	设计,产品,br,负责,工作,效果图,公司,产品设计,制作,客户
attendants	tAssisted,meeting,br,wedding,well,tCooperated,meetings,tAnswered,needs,service
首席执行官(CEO)/总裁/执行总监/总经理	br,公司,负责,管理,工作,经营,项目,运营,制定,全面
化妆师/造型师/服装/道具	造型,化妆,化妆师,br,妆面,搭配,新娘,设计,完成,拍摄
售前支持经理/主管	br,销售,客户,工作,负责,产品,项目,售前,技术,解决方案
公关/会务专员(助理)	br,工作,负责,客户,活动,公司,媒体,策划,公关,协助
公关主任/专员	br,客户,负责,撰写,执行,媒体,策划,销售,公关,品牌
项目执行/协调	br,项目,负责,工作,施工,协调,现场,管理,客户,工程
技术工程师	br,负责,工作,工艺,设计,产品,生产,设备,调试,技术
数据通信工程师	br,负责,设备,维护,工作,主要,项目,测试,调试,网络
发行总监/经理/主管	br,工作,发行,负责,团队,杂志,发行部,部门,渠道,平面设计
Cost administrators	manufacture,loss,goods,financial,calculate,provide,transfer,price,departments,reports
晒板/拼版/装订/烫金技工	工作,主要,脚钉,就是,装订
锅炉工程师/技师	锅炉,工作,运行,br,负责,设备,设计,维护,现场,调试
wireless communications engineer	development,wireless,software,protocol,testing,responsible,terminal,stack,detailed,layer
调酒师	酒水,吧台,饮品,制作,出品,管理,br,调酒,负责,鸡尾酒
房地产中介/交易	客户,br,二手房,租赁,负责,房源,销售,促成,工作,买卖
气象	气象,推广,报账,用车,报税,1988,工作,天气预报,负责,2010
人力资源/人事主管	br,员工,工作,招聘,负责,公司,培训,管理,考勤,入职
Equipment Engineer (debug / installation / maintenance)	debugging,system,machine,such,training,software,selection,scanning,process,participate
network information security engineer	web,Training,save,Managers,Chinese,language,simple,Support,Check,Sales
冲压工程师/技师	模具,br,设计,冲压,工作,产品,负责,试模,工艺,维修
船长/副船长	甲板,三副,驾驶员,职务,期间,作业,海上,IMO,航行,多年
工程与项目实施	br,调试,项目,负责,安装,设备,工作,设计,系统,产品
家具制造	负责,生产,家具,产品,主要,包装,设计,工作,工艺流程,执行
汽车质量管理	br,质量,工作,负责,供应商,检验,进行,管理,问题,审核
风险管理/稽核/控制/法律	br,风险,客户,工作,负责,审核,进行,审查,公司,项目
可靠度工程师	br,测试,产品,实验,实验室,试验,品质,确保,追踪,异常
家具/家居用品设计	设计,家具,客户,br,效果图,制作,产品,工作,方案,负责
结构工程师	br,产品,设计,结构设计,负责,工作,结构,模具,BOM,图纸
基建工程师	br,生产,图纸,处理,RMB4000,检测,配合,配电,设计,基建
Automatic Control engineers / technician	br,technical,solution,products,Provide,customers,training,distributors,win,some
产品或工艺工程师	负责,br,产品,工艺,生产,调试,工作,主要,工艺流程,车间
储备经理人	客户,br,销售,团队,管理,业务,协助,进行,工作,招聘
网站维护/管理	网站,br,维护,负责,工作,公司,推广,网络,优化,更新
智能大厦/综合布线/弱电	安装,工程师,现场,负责,指导,工作,楼宇,电路,电控柜,设计
统计/计划/调度	生产,br,计划,负责,工作,订单,物料,车间,协调,进度
渠道/分销代表	销售,客户,br,负责,工作,维护,产品,渠道,开发,公司
推档/放码	严谨,大货,一系列,排料,工作,放码,读图,根据,确认,样板
电路工程师/技术员（模拟/数字）	调试,br,工作,设计,PCB,负责,电路,维修,测试,产品
质量管理(QA)/质量控制(QC)	br,质量,品质,负责,工作,检验,供应商,产品,管理,客户
技工/普工	工作,生产,负责,主要,维修,加工,产品,设备,操作,br
高级物业顾问/物业顾问	br,负责,工作,公司,物业公司,租赁,陪同,项目,管控,物业管理
媒介购买	媒体,br,客户,排期,工作,负责,媒介,广告,销售,投放
Sales Assistant / Sales Administrative Assistant	sales,br,manager,report,team,market,work,help,collect,marketing
主持人/播音员/DJ	br,主持,负责,主持人,节目,编辑,工作,策划,播音,新闻
嵌入式硬件开发（主板机）	br,硬件,设计,原理图,调试,PCB,负责,开发,单片机,工作
证券/外汇/期货经纪人	客户,br,维护,工作,开发,投资,公司,负责,证券,提供
渠道/分销总监	br,销售,负责,渠道,工作,团队,管理,制定,客户,公司
Chemical Laboratory researcher / technician	antibodies,frozen,screen,lines,obtain,prepared,cell,hybridoma,fusion,were
招聘专员/助理	招聘,br,面试,负责,简历,工作,员工,入职,协助,筛选
注塑工程师/技师	模具,br,注塑,工作,生产,模具设计,完成,工艺,经验,制作
地质/矿产/冶金	工作,br,负责,地质,生产,矿山,管理,技术,主要,进行
医药招商	br,工作,销售,客户,招商,代理商,药品,渠道,负责,筛选
财务分析经理/主管	br,分析,财务,预算,负责,公司,工作,报表,管理,编制
Tax Commissioner / Assistant	them,representatives,means,these,make,tax,use,should,their,valid
Chemical Technology Applications	concentrated,flaw,knowledge,reference,process,producing,up,improvement,workshop,br
电子元器件工程师	br,元器件,负责,测试,工作,技术,电子,主要,研发,器件
成本经理/主管	br,成本,成本核算,负责,工作,核算,分析,管理,审核,报表
customer hotline call center staff	br,features,sales,guests,8thManage,use,management,requirements,guest,service
房地产开发/策划主管(专员)	项目,br,策划,负责,工作,营销,营销策划,推广,市场调研,撰写
人力资源/人事经理	br,公司,员工,工作,招聘,负责,培训,人力资源,管理,组织
electrician	technical,assistance,user
system testing	br,script,test,requirement,t5,testing,up,set,through,result
纸样/车板/唛架/吓数	制作,纸样,负责,为主,生产,工艺,设计师,br,车间,大货
R & D manager / director	design,team,br,technical,control,total,tracked,project,time,Sunnyvale
商务专员	客户,br,销售,负责,工作,公司,维护,产品,沟通,电话
foreign trade / trade manager / supervisor	br,sales,customers,market,international,new,charge,exhibition,amp,trade
轨道工程师/技术员	负责,br,车间,调试,安装,设备,工作,维护,技术,设计
数据库开发/管理	数据库,br,开发,数据,备份,维护,系统,负责,编写,工作
paint R & D engineer	customer,product,after,requirements,system,service,process,work,sale,three
化工实验室研究员/技术员	br,负责,检测,工作,实验,生产,产品,研发,工艺,进行
网站架构设计	br,网站,制作,公司,工作,设计,电子商务,平台,www,职位
factory director / deputy director	quality,system,improvement,br,up,process,product,planning,inc,management
行政总监	br,工作,公司,负责,管理,行政,组织,人力资源,员工,招聘
chief financial officer CFO	gt,functions,million,br,control,Established,subsidies,workshops,system,cost
城市规划与设计	规划,项目,设计,br,工作,图纸,参与,负责,规划设计,绘制
非应届毕业生	br,负责,工作,实习,学生,编写,进行,公司,收集,分析
储备干部	br,工作,负责,管理,学习,生产,培训,主要,熟悉,协助
化妆品研发	化妆品,配方,工作,产品,检测,独立,熟悉,改进,实习,测试
基金经理助理/证券分析	br,分析,投资,客户,研究,撰写,行业,工作,负责,报告
培训师	培训,br,负责,课程,工作,学生,员工,教学,学员,公司
公关/会务经理	br,活动,公关,工作,负责,策划,公司,客户,执行,媒体
采购总监	采购,br,供应商,负责,管理,工作,流程,公司,团队,采购部
吹塑/注塑工	生产,模具,负责,注塑机,br,注塑,产品,调机,试模,维护
客户投诉/协调	客户,投诉,br,处理,负责,工作,客服,问题,售后,沟通
project implementation / coordination	br,project,team,control,status,site,system,time,sure,sales
房地产项目招标专员	招标,br,工作,负责,文件,编制,投标,项目,合同,开标
室内外装潢设计	设计,施工图,br,设计师,效果图,工作,负责,客户,绘制,施工
大学教授	教学,br,课程,学生,教授,工作,英语,专业,大学,学院
assistant manager / secretary / clerk	br,work,related,department,order,office,manager,send,school,out
高级(资深)销售代表/客户经理(主任)/销售代	客户,销售,br,负责,工作,公司,维护,产品,开发,管理
products / production process (PE) engineers	production,br,yield,process,quality,daily,parameters,new,out,validate
服务员	工作,服务,客人,负责,服务员,顾客,br,点餐,主要,餐厅
健身顾问/教练	教练,健身,负责,会员,课程,工作,教学,学员,担任,瑜伽
电力工程师	工作,br,负责,电气,设备,工程,调试,安装,变电站,设计
电分操作员	工作,br,分色,主要,制造,输出,配货,根据,CMC,ISO9001
店长/卖场经理	br,管理,负责,销售,工作,员工,培训,日常,门店,人员
翻译	翻译,br,负责,工作,口译,文件,笔译,整理,签证,协助
保洁	星期,一个,时间,一天,抽出,图书馆,学院,干净,整理,保持
无线通信工程师	br,工作,负责,优化,网络,设计,项目,测试,基站,设备
品牌/产品专员(助理)	br,负责,产品,工作,推广,品牌,销售,策划,客户,公司
钳工/钣工/钣金工	装配,维修,设备,钳工,调试,工作,主要,从事,负责,安装
铸造/锻造工程师/技师	工艺,br,负责,设计,铸造,车间,生产,工作,主要,加工
版图设计工程师	br,设计,版图,PCB,电路,layout,原理图,验证,工程师,负责
列车司机	负责,驾驶,突发,故障,确保,客车,配货,接送,抢险,准时
intellectual property / patent consultant / Commissioner	Patent,about,documents,kinds,patent,many,into,mechanisms,al,related
食品/饮料研发	br,检测,工作,产品,研发,生产,进行,负责,检验,质量
美发师/形象设计	化妆,销售,造型,搭配,主要,服装,顾客,br,客人,产品
通信技术工程师	br,负责,工作,维护,设备,调试,网络,通信,设计,测试
机械工程师	设计,br,负责,工作,设备,产品,图纸,工艺,调试,项目
副总裁(VP)·副总经理	br,公司,负责,工作,管理,生产,项目,制定,组织,运营
buyer	quality,sector,claim,control,satisfied,result,occupied,out,visit,purchasing
策略总监	策划,br,推广,品牌,项目,执行,方案,客户,运营,传播
manager	br,management,production,up,team,training,system,quality,customer,project
媒介(企划)经理/主管	br,媒体,策划,工作,负责,媒介,客户,推广,活动,广告
护理主任/护士长	护理,护士长,工作,br,管理,医院,护理人员,护士,治疗,护理部
夹具工程师/技师	设计,br,夹具,工装,负责,调试,工作,治具,产品,工艺
信贷/信用管理	客户,br,贷款,负责,工作,业务,贷后,协助,信贷,客户经理
ERP实施顾问	br,实施,ERP,负责,系统,工作,项目,培训,模块,客户
channels / distribution representative	potential,br,Sales,right,members,Verify,existing,leads,through,upgrades
executive manager / director / director of the office	br,work,management,office,up,including,cost,service,Responsible,daily
实验室研究人员	br,检测,工作,实验,实验室,负责,测试,主要,进行,样品
('null')	br,工作,通过,设计,销售,认证,从事,管理,厂家,负责
工艺品/珠宝设计鉴定	设计,br,珠宝首饰,负责,珠宝,客户,平面设计,从事,3D,流行
无线电工程师	br,设计,工作,电路,负责,射频,产品,单元,选型,技术支持
媒介(企划)专员/助理	br,负责,策划,活动,工作,媒体,客户,广告,媒介,协助
电脑操作员/打字员	负责,录入,工作,整理,主要,资料,打印,客户,公司,br
葡萄牙语翻译	翻译,工作,文件,br,葡萄牙语,安哥拉,口译,笔译,巴西,葡语
editor / journalist / photographer	training,examiner,Support,activity,modify,tests,Construct,painters,stuff,draft
出纳	现金,br,负责,日记账,工作,银行,发票,银行存款,出纳,保管
船员	工作,船舶,负责,设备,br,主要,维修,管理,船上,三管
设备工程师（调试/安装/维护）	设备,br,调试,维修,维护,负责,保养,安装,工作,生产
技术支持工程师	br,维护,负责,工作,客户,技术支持,系统,项目,安装,软件
汽车装配工艺工程师	工艺,br,装配,负责,汽车,工作,设计,编制,车间,现场
税务专员/助理	br,税务,发票,申报,工作,负责,纳税,报税,汇算,企业
教育产品开发	br,负责,工作,编辑,培训,课程,学生,策划,校对,教学
幕墙工程师	幕墙,设计,br,工程,施工图,施工,绘制,图纸,投标,工作
切割技工	切割,加工,激光,操作,编程,主要,生产,模具,负责,等离子
法务专员/助理	br,合同,公司,法律,负责,工作,协助,审核,法务,处理
guesthouse / hotel management	managed,within,tidy,telephone,month,management,guest,top,three,lounge
物业招商/租赁/租售	招商,br,工作,负责,客户,项目,租赁,商业,公司,商场
药品生产/质量管理	br,负责,工作,生产,质量,车间,GMP,药品,检验,验证
环境工程技术/园林景区	br,负责,调试,工作,设计,工程,污水处理,项目,编写,方案
品牌/产品主管	br,产品,工作,负责,销售,品牌,策划,管理,推广,培训
保险培训师	培训,br,负责,课程,督导,新人,讲师,授课,销售,岗前
car agencies engineer	development,product,transmission,spring,vulcanization,testing,gas,Product,seals,vulcanized
药品市场推广主管/专员	工作,br,产品,药品,推广,中标,收集,备案,销售,集团
铸造工/热处理	工作,热处理,工艺,生产,操作,主要,设计,工程师,处理,汽车
面包糕点加工	负责,制作,工作,br,面点,包装,生产,品质,主要,培训
品牌/产品经理	br,产品,负责,品牌,销售,工作,推广,公司,客户,策划
银行卡/电子银行/新业务开拓	信用卡,客户,br,业务,办理,负责,工作,大堂,银行,推广
电子技术研发工程师	br,设计,调试,PCB,产品,负责,原理图,工作,研发,测试
涂料研发工程师	br,涂料,配方,负责,研发,生产,产品,性能,实验室,水性
chief operating officer, COO	school,responsible,responsibities,business,process,over,work,overall,system,strategy
心理医生	心理咨询,心理,br,治疗,分析,测评,精神科,咨询,精神障碍,方法
园艺/园林/景观设计	br,设计,景观,施工图,工作,项目,负责,方案设计,景观设计,方案
空调工/电梯工/锅炉工	维修,工作,电梯,空调,安装,负责,保养,维护,锅炉,运行
market / planning manager	marketing,br,sales,team,market,strategy,product,organize,revenue,plan
采购经理/主管	采购,br,供应商,负责,工作,管理,物料,采购计划,公司,部门
Human Resources / Personnel Assistant	supervisor,statistical,monthly,company,work,system,related,times,urgent,taxes
工业(IE)工程师	br,改善,生产,工时,IE,制程,负责,现场,精益,作业
出版/发行	工作,负责,br,图书,发行,编辑,校对,主要,类别,全职
契约管理	br,保单,投保单,初审,问题,客户,录入,客服,回访,指导员
technical engineer	br,process,production,design,new,management,training,work,technology,product
布料/裁床/包装	包装,进行,工作,衣服,主要,完成,生产,团队,裁剪,实习
应届毕业生	br,工作,负责,实习,主要,协助,进行,公司,学习,熟悉
公共卫生/疾病控制	br,工作,科室,负责,客户,日常,从事,疾控中心,疫情,管理
绩效考核专员/助理	br,员工,工作,负责,绩效考核,绩效,协助,考勤,考核,部门
lobby manager / assistant manager / foreman	sales,br,office,meetings,guests,handle,networks,relationships,daily,increase
hardware engineers	buck,power,waveform,system,analysis,project,trial,production,solve,together
城市燃气技术人员	设计,燃气管,燃气,工作,负责,施工,管理,城市,管网,工程
编辑/记者/摄影	br,编辑,工作,负责,策划,稿件,新闻,采访,校对,实习
Commissioner for Information Technology	br,Java,up,testing,coding,VB,system,NT,through,troubleshooting
给排水/强弱电/制冷暖通	br,设计,施工,给排水,工作,负责,工程,项目,图纸,暖通
包装/印刷	机器,调试,各种,技术员,包装,组装,5s,抽查,认真,新近
software engineer	development,br,system,porting,Responsible,device,participate,based,platform,using
医疗器械维修人员	维修,安装,调试,负责,产品,设备,br,售后,客户,公司
financial analysis manager / supervisor	management,work,annual,financial,Prepare,obligations,some,related,Forecast,reports
声光技术	处理,问题,分析,不良,设备,技术支持,工程师,海洋,反馈,调查
房地产评估	评估,报告,房地产,项目,土地,负责,br,工作,进行,拆迁
after-sales support manager / supervisor	br,sales,team,support,customer,tough,give,into,related,servers
医疗设备注册	注册,工作,负责,产品,br,全职,协议,沟通,协助,器械
数码直印/菲林输出	输出,负责,根据,处理,EXCEL,胶卷,手机,CAD,WORD,以及
平面设计	设计,负责,br,工作,平面设计,公司,制作,海报,宣传,画册
多媒体/游戏开发工程师	游戏,开发,br,客户端,负责,模块,项目,工作,编写,系统
高级硬件工程师	br,硬件,负责,设计,开发,PCB,调试,工作,ARM,项目
工程/设备经理	设备,br,负责,管理,工作,维修,保养,公司,日常,维护
美容/整形师	美容,销售,顾客,培训,美容师,工作,负责,产品,主要,公司
import / letter of credit	finance,successful,marketing,thousand,responsible,any,credit,issuing,including,advertising
financial / economic researcher	real,monitored,estate,supply,support,within,update,research,securities,trends
兼职/临时	工作,负责,br,兼职,顾客,销售,主要,客户,协助,整理
熟食加工	工作,负责,兼职,期间,熟食,从事,培训,食品,客户,操作
前厅接待/礼仪/接线生	客人,接待,负责,工作,br,前台,入住,酒店,服务,退房
软件测试	测试,br,测试用例,编写,测试报告,测试计划,工作,负责,功能测试,项目
测绘/测量	测量,工作,施工,放线,负责,主要,br,现场,工程,放样
针灸/推拿/按摩	治疗,推拿,康复,主要,br,理疗,腰腿痛,针灸,拔罐,从事
tutor	level,students,two,Tutor,mathematics,teaching
维修工程师	设备,维修,br,负责,工作,维护,保养,调试,生产,安装
建筑设计/制图	设计,施工图,建筑,br,绘制,工作,项目,负责,主要,方案设计
产品规划工程师	br,产品,工作,设计,负责,测试,开发,生产,导入,客户
Automotive Electronics Engineer	design,br,control,development,communication,system,test,customer,project,requirement
模具工程师	模具,模具设计,br,设计,产品,3D,负责,试模,2D,加工
农林牧渔	负责,工作,管理,br,生产,技术,主要,种植,蔬菜,销售
商务经理/商务主管	br,负责,客户,销售,工作,公司,商务,合同,团队,管理
CAD/CAM	负责,工作,制版,服装,客户,样板,br,排版,推码,完成
飞行器设计与制造	br,设计,结构,工程图,零部件,机载设备,协助,燃气轮机,ANSYS,进行
快递员	工作,负责,客户,快件,快递,公司,br,处理,送货,收发
房地产开发/策划经理	项目,br,工作,策划,负责,营销,推广,公司,定位,方案
Legal Adviser	Working,adidas,provide,marketing,Nokia,reports,counterpart,USA,Sony
房产项目配套工程师	施工,br,工程,负责,设计,项目,工作,现场,图纸,审核
单证员/报关员	br,报关,单证,负责,制作,货物,工作,进出口,单据,客户
幼教	幼儿,工作,负责,br,家长,教学,幼儿园,教师,课程,班级
客户主任	br,客户,项目,活动,负责,策划,工作,沟通,推广,执行
工程监理	监理,施工,现场,工程,工作,br,负责,质量,验收,监理员
客户关系管理 (CRM)	客户,br,工作,负责,维护,销售,公司,客户关系,沟通,管理
consultant	br,training,financial,process,companies,within,month,writing,quality,insurance
临床研究/协调	br,临床试验,相关,中心,医院,文件,项目,实验,监查,应对
市场研究助理	br,宣传,工作,协助,客户,公司,产品,信息,营销,数据
project manager / product manager	new,Production,proto,implementation,when,improvement,production,build,week,product
供应链总监	br,供应商,采购,生产,流程,物流,年度,客户,制定,物料
中学教师	学生,教学,工作,班主任,教师,br,负责,担任,英语,辅导
岩土/基础地下工程	工作,负责,工程,br,施工,设计,现场,项目,岩土,勘察
Audit Commissioner / Assistant	br,audit,logistics,set,statements,receivables,certain,mainly,trade,manager
娱乐/餐饮管理	工作,负责,br,管理,餐厅,员工,营运,服务,培训,日常
4S店经理/维修站经理	负责,工作,客户,br,售后,维修,售后服务,管理,服务,制定
业务跟单经理	br,客户,负责,订单,工作,出货,跟踪,生产,跟单,采购
首席技术官CTO/首席信息官CIO	br,负责,工作,项目,公司,技术,管理,研发,团队,系统
客户服务经理/主管	br,客户,工作,负责,销售,客服,培训,维护,管理,公司
兼职教师	学生,教学,负责,辅导,课程,英语,br,工作,教授,教师
薪资福利专员/助理	br,员工,负责,考勤,薪酬,工作,薪资,福利,办理,管理
采购管理	采购,供应商,br,负责,工作,物料,管理,采购计划,交期,生产
面料辅料采购	采购,br,供应商,面料,负责,辅料,跟进,工作,大货,面辅料
后期制作/音效师	剪辑,制作,负责,后期制作,br,工作,宣传片,后期,包装,拍摄
导演/编导/制片	br,拍摄,节目,策划,制作,导演,负责,工作,编导,宣传片
创意指导/总监	br,设计,策划,负责,创意,工作,客户,项目,团队,品牌
电声工程师	br,负责,测试,箱体,ERP,音响,纸盆,婚庆,Excel,控场
网络工程师	维护,br,网络,负责,公司,服务器,工作,安装,项目,调试
银行柜员//银行会计	业务,br,柜员,客户,工作,办理,银行,负责,对公,柜台
supplier management	br,up,supplier,responsible,new,product,team,project,work,supply
有线传输工程师	br,传输,设计,负责,工作,工程,网络,设备,移动,通信
part-time / temporary	Worked,shop,managers,feedback,office,recount,Sales,produced,including,quality
professional adviser	within,site,reviewing,station,universities,speakers,registering,six,three,hydropower
印刷机械机长/打稿机操作员	印刷机,br,根据,快递,缓急,调色,油墨,交货,安排,客户
物控经理/主管	br,物料,生产,计划,工作,管理,仓库,部门,负责,库存
实习生	br,工作,实习,负责,协助,整理,学习,客户,进行,主要
总裁助理·总经理助理	br,工作,负责,公司,协助,总经理,管理,日常,部门,项目
采购员/助理	采购,br,供应商,负责,工作,物料,订单,采购计划,交期,公司
投融资经理/主管	br,融资,银行,公司,资金,工作,负责,管理,项目,集团
集成电路IC设计/应用工程师	br,设计,验证,芯片,测试,编写,FPGA,模块,仿真,工作
Chief Technology Officer CTO / Chief Information Officer CIO	relationships,setup,service,route,Setup,successfully,system,running,virus,tailor
分公司经理/分支机构经理/办事处经理	br,负责,销售,工作,管理,分公司,团队,公司,客户,区域
医药研发/化学制剂研发	br,合成,研发,工作,负责,实验,工艺,检测,实验室,路线
物业管理专员/助理	工作,负责,br,业主,投诉,处理,管理,物业,报修,装修
技术研发工程师	br,设计,负责,工作,产品,开发,研发,项目,调试,设备
保险核保	核保,br,负责,工作,业务,保险,协助,培训,进行,主要
电力工程师/技术员	设备,br,负责,工作,维护,调试,安装,维修,电气,检修
R & D engineer	br,products,through,problems,parts,including,design,signing,tasks,solved
营运主管	br,生产,管理,工作,负责,计划,协调,销售,现场,营运
materials competent / Commissioner	br,team,warranty,unsolved,supply,Create,urgent,orders,unit,weekly
channel / distribution Leader	force,target,transportation,wall,marketing,sales,three,rubber,etc,thermal
驻外经理 (Country Manager)	br,负责,管理,销售,工作,团队,公司,区域,开发,分公司
汽车电子工程师	br,设计,负责,开发,整车,项目,线束,调试,硬件,工作
logistics Commissioner / Assistant	material,responsible,supervisor,my,make,time,up,so,export,customs
undefined	培训,工作,负责,车间,工模,模具,控制,注塑,加工,提出
网页设计/制作/美工	设计,网站,制作,br,页面,负责,网页,公司,工作,com
实验室负责人/工程师	br,测试,工作,实验室,产品,负责,维护,项目,设备,测试报告
纺织机械	工作,图纸,设计,调试,改进,机械设计,设备,担任,电脑,br
售后支持工程师	客户,br,负责,售后,工作,调试,维修,安装,维护,设备
intelligence gathering and information analysis	within,br,intelligence,pro,sales,sources,growth,through,tools,management
激光/光电子技术	br,设计,激光,激光器,研发,测试,光学,调试,模块,成像
Systems Engineer	br,sales,major,via,win,Support,testing,servers,tasks,design
德语翻译	翻译,德语,工作,负责,br,德国,客户,邮件,口译,陪同
配套设计	服装,销售,橱窗,展示
大堂经理/副理/领班	工作,负责,br,员工,客人,管理,酒店,接待,前厅,投诉
网站编辑	网站,br,负责,编辑,策划,更新,工作,推广,专题,内容
lecturer / assistant	br,English,Teaching,tutor,students,operations,interpretation,adults,achieved,win
embedded system software development (Singlechip DLC DSP)	venders,program,product,schedule,verify,station,searching,application,running,produce
Test Engineer	test,br,products,production,new,such,setup,work,EMC,communication
人事中介	工作,br,招聘,负责,面试,公司,主要,学生,培训,客户
投资顾问/理财顾问/客户服务	客户,br,理财,负责,工作,投资,业务,维护,理财产品,开发
purchasing manager / supervisor	br,supplier,suppliers,team,cost,material,etc,sourcing,purchasing,management
首席运营官COO	br,公司,负责,运营,管理,工作,团队,制定,品牌,项目
计算机辅助设计工程师	br,设计,培训,职位,工作,软件,调试,负责,编程,photoshop
客户总监	br,执行,策划,项目,客户,公关,比稿,服务,品牌,全案
法语翻译	翻译,工作,法语,负责,br,口译,陪同,笔译,文件,日常
摄影/摄像	拍摄,摄影,负责,摄影师,br,工作,后期,摄像,主要,完成
财务主管/总帐主管	br,负责,工作,财务,公司,编制,报表,审核,税务,核算
电信交换工程师	br,维护,工作,设备,软交换,工程师,交换机,交换,调试,技术支持
技术总监/经理	br,负责,团队,系统,技术,工作,公司,管理,项目,开发
成本管理员	br,成本,核算,工作,负责,成本核算,分析,报表,费用,审核
兽医	主要,治疗,每天,担任,宠物,兽医,种猪,动物,状况,零零
sawing machine operator/ lathe / grinder / milling machine / punch / gong bed	set,requirements,samples,process,make,lathe,up,production,program,products
渠道/分销经理	br,销售,负责,渠道,客户,工作,管理,公司,维护,区域
the audit manager / director	audit,who,utmost,target,business,company,work,profession,will,etc
物业设施管理人员	工作,br,负责,维护,系统,设施,维修,消防,设备,职责
朝鲜语翻译	翻译,工作,韩国,韩语,负责,br,口译,客户,日常,笔译
办事处首席代表	br,工作,负责,管理,销售,办事处,客户,项目,公司,分公司
human resources / personnel director	control,training,Standardize,start,HR,manage,year,recruit,project,process
置业顾问	客户,销售,br,工作,负责,接待,楼盘,项目,看房,成交
飞机维修机械师	维修,飞机,工作,br,维护,优秀,机务,2013,航线,娱乐
拍卖/典当	br,负责,流程,客户,风险,公司,项目,典当,买卖,213
店员/营业员/服务员	工作,负责,销售,顾客,br,服务,收银,主要,商品,服务员
经销商/代理商	销售,负责,br,客户,工作,产品,公司,经销商,代理,主要
演员/模特/配音	舞蹈,演员,工作,演出,表演,br,参加,合唱,舞蹈演员,2013
保安	工作,安全,负责,br,保安,公司,维护,治安,巡逻,管理
网站营运经理/主管	br,运营,网站,负责,推广,策划,工作,产品,优化,公司
行长/副行长/高级管理	支行,br,业务,负责,客户,管理,公司,分行,工作,副行长
建筑工程管理	施工,br,负责,工程,工作,管理,项目,现场,质量,技术
市场专员/助理	br,负责,工作,客户,推广,公司,销售,活动,协助,产品
senior software engineer	br,development,project,technology,driver,2006,Web,code,protocol,MIB
美术编辑	设计,负责,排版,工作,杂志,br,制作,编辑,美术,主要
汽车修理人员	维修,汽车,保养,车辆,工作,负责,主要,进行,故障,日常
后勤	负责,br,工作,管理,整理,公司,日常,考勤,客户,员工
市场策划/企划	br,策划,活动,负责,工作,推广,公司,营销,执行,宣传
FAE Field Application Engineer	development,customer,multiple,technical,wcdma,company,supported,up,Huawei,solve
产品工艺/制造工程师	br,工艺,产品,负责,制程,制作,测试,生产,设备,导入
财务/会计助理	br,凭证,工作,会计,负责,发票,记账,协助,整理,财务
electronic technology R & D engineer	design,program,test,software,hardware,electronic,develop,br,control,named
演艺/体育经纪人/星探	艺人,br,工作,演出,活动,经纪人,助理,沟通,演艺,电视剧
国际结算/外汇交易	br,业务,客户,工作,负责,分析,结算,外汇,实习,信用证
Module engineer	mold,design,review,br,products,shot,manufacture,using,trial,drawing
动漫/卡通设计	动画,制作,设计,br,负责,场景,工作,绘制,原画,主要
质量管理/验货/质检/品控	质量,负责,br,生产,工作,工厂,服装,大货,品质,工艺
售后支持经理/主管	br,负责,工作,客户,售后,售后服务,产品,销售,管理,维修
Project Manager / supervisor	br,design,review,new,tooling,project,production,cost,training,quality
店面/陈列设计	br,设计,工作,负责,效果图,店面,陈列,施工图,制作,图纸
仓库经理/主管	仓库,br,工作,管理,负责,盘点,物料,仓储,日常,部门
市场/企划经理	br,负责,策划,工作,推广,活动,品牌,公司,市场,制定
其他	br,负责,工作,客户,主要,公司,销售,管理,协助,进行
区域销售经理`销售经理/主管	销售,br,负责,客户,工作,区域,公司,管理,维护,团队
汽车设计工程师	br,设计,工作,负责,零部件,开发,项目,系统,产品,车身
communication technology engineer	Support,department,br,work,project,each,throuth,bidding,regulated,engaged
裁剪师/电剪	工作,裁床,排料,裁剪,开刀,沟通,协助,薪水,流程,打样
President, Assistant General Manager Assistant	br,work,management,company,meetings,team,Assisting,up,training,meeting
PMC/SMT技术员	br,生产,物料,计划,订单,负责,工作,跟进,处理,交期
fitness consultant / coach	br,tasks,turned,coach,air,temperature,various,systems,indicators,performance
electronic engineer / technician	layout,Responsible,design,test,product,br,work,major,responsible,process
服装打样/制版	制版,样衣,工艺,制作,负责,br,服装,大货,纸样,版型
科研人员	br,工作,负责,研究,项目,参与,研发,主要,设计,产品
生鲜食品加工	br,工作,生鲜,培训,生产,日常,标准,管理,餐厅,公司
vice president (VP), deputy general manager	management,financial,br,control,Management,office,process,Responsible,mainly,site
consulting manager / supervisor	trends,market,br,industrial,advices,tCooperate,tConstruct,strategy,their,tMake
primary school teacher	loved,use,success,matter,these,work,school,leader,will,students
产品工艺/制程工程师	br,工艺,产品,生产,负责,设计,工装,工作,编制,现场
secondary school teacher	relevant,necessary,getting,required,legally,stay,courses,other,English,documents
bank card / electronic banking / new business development	planning,prospective,regarding,group,wealth,business,support,presentations,research,satisfaction
Financial Director	praised,training,gt,financial,over,HQ,system,related,refunding,verification
产品经理/主管	br,产品,负责,项目,工作,用户,需求,文档,分析,客户
automotive quality management	whose,them,sure,SAIC,chromatism,bumpers,process,was,work,member
买手	br,供应商,采购,负责,销售,产品,工作,交期,处理,开发新
首席财务官CFO	财务,br,工作,公司,财务管理,负责,管理,税务,预算,制定
地勤人员	工作,旅客,负责,br,登机,行李,办理,接待,服务,主要
C&B manager / supervisor	purchase,mechanism,job,relocation,trends,merit,policy,restructuring,program,solutions
entertainment / catering management	scheduled,them,good,well,work,when,training,cooperate,relative,station
Electrical Engineering	Project,bidding,equipment,managing,system,project,etc,charge,construction,including
金融/经济研究员	br,研究,分析,撰写,行业,报告,投资,负责,公司,工作
销售工程师	客户,销售,br,负责,工作,产品,维护,公司,开发,拜访
Regional Sales Manager `sales manager / director	br,customers,customer,sales,products,business,team,new,management,project
quality management / inspection / quality control	customer,major,responsible,Carrefour,Camaieu,quality,required,Mainly,customers,standard
Customer Relationship Management (CRM)	Sell,gathering,estate,executing,message,market,relationships,information,feeding,sustain
certified engineer / auditor	audit,ISO9001,management,qualification,ten,trial,quality,company,responsible,system
医药技术研发管理人员	br,负责,研发,产品,工作,GMP,工艺,项目,实验室,小试
Finance Manager	financial,br,work,department,management,budget,Making,system,company,up
Internet software development engineer	development,frame,end,front,protocol,Web,communication,site,library,technology
Trade	sales,manager,tasks,foreign,make,responsible,window,visas,product,business
业务总监	客户,br,活动,公关,团队,品牌,策划,广告,负责,传播
domestic trade officer	Provided,requirement,relevant,Excel,searching,trade,abilities,follow,ship,orders
电焊工/铆焊工	焊接,工作,从事,电焊,主要,焊工,管道,安装,氩弧焊,负责
项目经理/产品经理	br,产品,项目,负责,工作,研发,客户,管理,项目管理,设计
High (Senior) Sales Representative / Account Manager (director) / sales represen	customer,customers,br,technical,up,sales,team,new,management,month
System Engineer / Auditor	system,br,process,quality,up,manage,results,module,drive,audit
市场研究经理/主管	负责,br,团队,客户,工作,维护,研究,培训,品牌,调研
医疗设备生产/质量管理	br,生产,工作,负责,质量,设备,检验,全职,职位,产品
实验室管理人员	br,负责,检测,实验室,工作,检验,仪器,实验,日常,管理
房地产销售人员	客户,销售,工作,br,负责,楼盘,顾问,二手房,置业,接待
智能大厦综合布线	安装,调试,弱电,设计,技术支持,br,布线,施工单位,售后服务,施工
manager / store manager	Management,Administration,store
电气工程	施工,br,负责,电气,工程,设计,工作,图纸,现场,安装
影视策划/制作人员	制作,工作,负责,br,剪辑,拍摄,后期制作,宣传片,策划,后期
塑料工程师	br,产品,ABS,配方,研发,阻燃,工艺,负责,工作,挤出机
资产评估/分析	br,项目,评估,进行,撰写,分析,投资,工作,负责,报告
原型分析	分析,有限元,寿命,功能性,连接器,疲劳,测试,性能,建立,br
real estate agent / transactor	leasing,management,br,negotiation,control,retailer,Consultancy,high,amp,market
保险代理/经纪	客户,销售,保险,br,工作,负责,维护,培训,老客户,电话
薪资福利经理/主管	br,薪酬,员工,负责,福利,薪资,公司,绩效,管理,工作
Japanese translator	into,Translate,Japanese,Chinese
信息技术经理/主管	br,系统,负责,维护,管理,公司,工作,项目,服务器,网络
系统分析师/架构设计师	br,设计,系统,开发,项目,负责,工作,架构设计,平台,研发
铲车/叉车工	叉车,工作,负责,司机,货物,铲车,装卸,仓库,保养,br
陈列/展示设计师	陈列,店铺,橱窗,br,制作,培训,负责,设计,手册,搭配
telecommunications network engineer	use,set,DTN,role,up,residing,WSN,project,design,user
英语翻译	翻译,br,负责,工作,口译,客户,公司,资料,笔译,陪同
保险产品开发/项目策划	br,产品开发,产品,SAS,保险,经营,制定,参与,开发,报告
fund manager Assistant / Securities Analysis	Quantitive,testing,prediction,collection,back,intern,analysis,br,polishing,modeling
专业顾问	br,客户,项目,工作,咨询,负责,培训,管理,企业,顾问
部门经理	br,负责,工作,管理,公司,部门,销售,生产,项目,制定
安全消防	安全,工作,负责,br,消防,管理,生产,公司,检查,维护
English translator	br,translation,technical,work,documents,translate,team,various,English,etc
production clerks	strength,obey,profound,rules,my,strictly,work,system,understanding,regulations
调墨技师	油墨,从事,检测,性能,配置,主要,相关
船务/空运/陆运运输	br,订舱,负责,报关,客户,货物,安排,提单,制作,工作
理货员/陈列员/统计员	工作,商品,br,负责,货架,陈列,整理,盘点,理货,销售
会计	br,负责,工作,编制,凭证,账务,会计,报表,审核,核算
structural / civil / construction engineer	supervisor,some,them,private,Proprietor,sports,variety,writing,structural,2011
电工	维修,设备,维护,安装,负责,保养,工作,调试,电气,br
法务经理/主管	br,公司,合同,法律,负责,诉讼,法律事务,起草,工作,审核
美甲师	美甲,自己,整体,气质,相关,天性,女人,每月,外表,经历
生产经理/车间主任	生产,br,管理,负责,车间,工作,计划,部门,员工,设备
物料经理	br,负责,物料,采购,管理,生产,计划,库存,供应链,仓库
CNC工程师	加工,编程,CNC,br,数控,操作,负责,中心,工艺,主要
商务助理	br,客户,负责,工作,销售,协助,公司,订单,合同,整理
硬件工程师	br,硬件,负责,设计,PCB,工作,测试,调试,原理图,维护
咨询经理/主管	br,项目,客户,负责,咨询,培训,工作,管理,企业,分析
理货员	货物,负责,理货,工作,发货,客户,br,管理,物流,仓库
绩效考核经理/主管	br,工作,绩效,绩效考核,负责,组织,管理,考核,公司,员工
体系工程师/审核员	br,审核,负责,体系,管理,管理体系,公司,质量,ISO9001,工作
ERP technology development	br,LTD,Ltd,R12,Co,ORACLE,2008,YI,ERP,Network
毛衣缝盘/毛衣挑撞/洗水	深圳市,优秀,开发,裤业,工艺,师傅
Technical Clerk / Assistant	computerization,management,network,Database,process,backup,manage,etc,program,references
公路/桥梁/港口/隧道工程师	施工,br,工作,负责,工程,现场,技术,桥梁,测量,项目
二手车评估师	二手车,评估,负责,客户,车辆,置换,过户,br,销售,工作
Operations Manager	product,SPS,improved,Make,time,charge,improvement,delivery,rate,without
Transport Manager / director	cargo,Charter,within,voyage,both,when,us,disputes,br,parties
container business	information,tCollect,br,tEnter,items,route,upload,shipping,system,charges
Data Communications Engineer	provided,management,network,technical,support,resolving,project,planning,including,issues
宾馆/酒店管理	酒店,工作,负责,br,管理,员工,客房,客人,部门,培训
通信电源工程师	br,负责,电源,设计,工程师,通信,安装,设备,项目,系统
化验/检验	检验,br,负责,检测,工作,产品,生产,进行,成品,质量
物流总监	物流,br,管理,负责,制定,仓储,工作,流程,公司,配送
茶艺师	茶叶,茶艺,br,表演,销售,工作,接待,冲泡,功夫茶,知识
other	br,team,new,training,work,quality,production,design,marketing,test
核力/火力工程师	br,工作,负责,设计,核电站,施工,管道,安装,设备,质量
Customer Service Commissioner / Assistant	customer,control,services,complains,managing,Service,goods,Responsible,Agent,solutions
Market Commissioner / Assistant	br,marketing,up,suppliers,release,research,promotion,market,company,project
模拟电路设计/应用工程师	br,设计,PCB,电路,电路设计,模拟,原理图,仿真,工作,测试
股票/期货操盘手	交易,br,分析,期货,客户,操盘,负责,公司,投资,工作
Failure Analysis Engineer	control,metallurgical,maintenance,process,numerical,meantime,equipment,production,master,br
real estate development / project manager	real,retailers,tManagement,tAs,tAnchor,hotel,strategy,tInvestment,projects,br
part-time teacher	students,br,student,teaching,skills,interpersonal,knowledge,their,better,written
互联网软件开发工程师	开发,br,负责,网站,项目,维护,设计,工作,系统,后台
艺术/设计总监	设计,br,负责,工作,项目,公司,设计部,制作,产品,客户
System Administrator / Network Administrator	system,br,support,troubleshooting,technology,users,virus,user,team,tPlan
项目工程师	br,负责,产品,设计,工作,项目,客户,生产,开发,工艺
项目总监/经理	br,项目,负责,工作,管理,客户,项目经理,施工,公司,工程
护士/护理人员	护理,工作,病人,护士,实习,输液,br,医生,临床,医院
publication / distribution	Translating,editing,books
系统测试	测试,br,测试用例,编写,负责,工作,测试报告,测试计划,系统,项目
database development / management	database,system,br,Develope,make,optimize,maintain,requirement,relevant,financial
厨师	负责,工作,厨房,制作,厨师,菜品,br,主要,员工,厨师长
变压器与磁电工程师	变压器,br,工艺,设计,生产,产品,验证,调试,负责,跟踪
Manufacturing Engineer	process,design,production,problems,br,Productivity,product,solution,Production,PCB
Human Resources / Personnel Manager	br,HR,management,amp,process,staff,team,system,ensure,employee
排版设计/完稿	排版,设计,工作,br,制作,负责,主要,印刷,软件,客户
project director / manager	br,project,team,management,work,new,training,service,support,customer
医院管理人员	br,工作,医院,负责,科室,管理,培训,患者,职责,临床
半导体工程师	br,设备,工艺,负责,产品,工作,异常,良率,维护,半导体
药品市场推广经理	br,产品,售后,医院,工作,团队,学术,专家,负责,做好
模具工程师/模具工	模具,维修,br,加工,工作,生产,负责,设计,主要,调试
玩具设计	设计,产品,玩具,br,外观设计,效果图,平面设计,根据,建模,客户
兼职店员	工作,负责,顾客,兼职,br,服务,收银,客人,主要,服务员
西班牙语翻译	翻译,负责,工作,西班牙语,br,西语,公司,协助,口译,陪同
information technology manager / supervisor	network,system,br,business,up,including,implementation,new,team,manage
工厂厂长/副厂长	生产,br,管理,负责,工作,工厂,计划,公司,设备,车间
水工/木工/油漆工	喷漆,工作,负责,油漆,喷涂,汽车,安装,木工,主要,从事
汽车修理工/机修工	维修,负责,保养,工作,汽车,设备,维护,br,主要,故障
injection engineers / technician	repair,management,molding,process,warm,understanding,machine,skills,production,so
technical director / manager	03,01,R12,1.3,05,HUHEI,JLLIN,br,EBS,ORACLE
结构/土木/土建工程师	施工,br,负责,工作,工程,现场,项目,图纸,设计,技术
集装箱业务	工作,br,集装箱,客户,货代,操作,协调,负责,处理,反馈
