word、PPT	生物信息工程师
Simulink	电气工程师,研发工程师
ERP2代操作系统	合同管理员
Microsoft Visual C++编程语言	软件工程师,技术支持工程师,c++开发工程师,机械电子,电气技术员/助理电气工程师,无,iOS软件工程师, 会计/审计；金融/投资/证券,软件测试，网站设计，手机应用开发,C++程序员
Microsoft PowerPoint	研究员,金融、精算、销售、管理、咨询,数据分析处理,erp实施顾问,管理培训生,人力资源管理,行政人事专员／销售,财务会计,财务经理,审计助理
Office / excel	机械设计  工艺
音频工程	国际工程销售
altium designer	硬件工程师
3Dmax、CAD	工业设计师
Keil uVision4	嵌入式开发工程师
USRP	专利管理
WPS Office	办公室文员
统计过程控制	Production manager
Visual C++ 6.0	硬件研发工程师
office软件熟练	法务助理
SSH框架	java,软件开发工程师,JAVA软件开发工程师,软件测试工程师,java软件工程师,java开发工程师,Java开发工程师
ZooKeeper	Linux软件开发工程师
final cut	剪辑
精通c	软件开发工程师
自动化测试	Software QA,软件测试工程师
matlab	工程师,软件开发工程师,软件研发工程师,数据分析,图像算法工程师,通信技术工程师,量化投资程序员,射频工程师
公路运输	行政经理
struts2、hibernate、	java开发工程师
Apache	网站运营,程序员
熟练应用Office办公软件	平面设计师 美编
SPC	生产主管
分散控制系统 (DCS)	生产经理
Primavera P6	历任技术员、技术负责人、技术科长
GU	项目工程师
Verilog HDL语言	FPGA设计开发工程师
Sun Microsystems认证	售前/售后工程师
PADS	助理电子工程师,硬件开发工程师,集成电路设计/验证工程师
HTML+CSS	软件工程师
js语法与jQuery框架	java软件开发工程师
教务	教学及相关管理工作
采购分析	采购科科长
电话销售	客户经理,销售代表,公关、活动执行策划等,销售 市场 客户经理 网站运营,数据库管理、质量管理、人事管理、物流管理、销售、市场,培训助理 培训师 培训专员,业务主管,行政 人事,实习生,销售
auto cad	网络工程师,弱电工程师
Origin	测试/分析工程师,研发工程师,全职
Objective-c	ios游戏开发工程师
生产件批准程序（PPAP）	制造管理类（品质、研发、制造生产）岗,质保类
金融风险管理	销售经理
面试技巧	经理助理,销售助理
办公自动化	外贸助理
WINCC	技术员
证券交易	内勤
COBOL	高级开发人员,计算机软、硬件/互联网/IT
FPGA设计	FPGA工程师/硬件研发工程师,硬件工程师,计算机维护,嵌入式工程师,FPGA设计验证工程师
计算机中级证	车间主任
POWERPOINT	园林绿化设计
劳动合同管理	人事助理
绘声绘影视频制作软件	银行柜员
搜索引擎营销 (SEM)	市场营销/电子商务经理,区域支持经理,SEM主管、网站运营主管,网络推广,市场部经理
Pro/Engineer	技术员
国家计算机等级三级	供应链管理
Java语言	android应用工程师,软件开发,软件测试工程师,嵌入式软件开发
数据库编程语言	电气工程师
研究技能	技术工程师
嵌入式系统	卫星导航/嵌入式软件工程师
计算机软件	java软件工程师,财务会计助理，行政助理,法务专员、法务助理、行政助理,高级软件工程师,销售总监，销售顾问,项目管理，技术支持,软件工程师,会计助理,项目部经理,行政助理
hibernate	java软件工程师,java开发工程师,java程序员, ,java,软件开发工程师,java软件工程师相关岗位,Java Web开发程序员,Java软件工程师
soildworks	CNC车床技术员
ajax,jquery框架	人力资源助理
用例设计方法	软件测试工程师
谈判技巧	渠道/分销经理,行政,采购员,销售，管理，业务,促销员
SQL Server	软件工程师,研发部,前端工程师,研发总监,c/c++,C、C++软件工程师,网络管理员,项目经理/主管/产品经理,android开发,图像算法工程师
技工 	技术员
Tomcat应用服务器应用配置	测试工程师
SAP Business One	无
C/C++程序设计	嵌入式软件工程师
报批报建	常务副总裁
C/C++ 	手机研发,地图研发
渠道管理	项目经理，销售经理
电气自动化	电气工程师,自动化工程师,产品经理,电气工程师（矿山电气，强电为主，PLC、变频等）,电气维修,应用程序开发工程师,电气工程师、机电技工+班组长,服务工程师
Linux设备驱动开发、移植	Android驱动工程师
Html+js+css3	iOS研发工程师
linux系统	项目经理,测试工程师,嵌入式软件工程师,IC设计工程师,java开发工程师,c语言开发工程师
Oracle PL-SQL	程序员,数据库管理员,软件工程师,BI,业务需求顾问,技术工程师
建龙软件	房产机电工程师
自动化测试辅助工具Selenium	软件测试工程师
品质七手法	部门经理
数据库技术	电子商务专员 网站推广 网站编辑 网站优化,软件工程师,java程序员,证券分析  行业分析
绘画能力	设计师,产品设计师,原创歌手、音乐教师、音乐制作、游戏配乐、婚庆类等相关行业,实习生,平面摄影师,陈列师,教师
英语作为外语(EFL/TEFL)	兼职英语老师、助教或翻译,Tutor 语言指导老师,市场拓展，市场销售管理,软件工程师,行政、人事助理,法语相关职位,翻译,销售经理
6西格玛绿带 	模具项目工程师
Javascript脚本语言及页面特效开	.Net 软件工程师
Microsoft Visual Studio	软件工程师,售前工程师,人力资源管理
Hughes Technologies mSQL	php开发工程师
熟练运用word、excel、ppt	技术工程师
CAD,MDS二维绘图	游戏在线客服
OHSAS18001	硬件工程师
熟练	房地产开发公司总工　,销售助理/业务跟单
桌面/办公软件	销售代表,行政人事文秘助理等之类的工作, 会计 财务会计,单证员 ,外贸业务员,客服专员,技术支持工程师,质检、实验室助理,理财分析师,发行助理
三维软件Proe	机械设计师
3DMax	设计师，助理均可,网络维护
SqlSever 熟练 |48	.net软件工程师
华为3Com认证网络工程师初级	打字员
市场策划	市场助理,策划与营销,营销总监,策划经理
mentor	主管
Creo 2.0	产品设计工程师
关系型数据库基础	java程序员
CAD  	销售工程师,机械设计工程师
ANSYS有限元分析	机械工程师
VBA	投资银行业务分析师,量化投研岗
CCIE (Cisco Certified Internetwork Expert)	项目经理,总监
VHDL	FPGA工程师,高级硬件工程师
美术教学	管理培训生 储备干部 执行助理
英语cet4级	财务 会计
BEA WebLogic Server	软件工程师
Enterprise JavaBeans (EJB)	软件工程师
国家三级裁判员（足球项目）	项目营销策划经理
opencv视觉库	视频算法工程师
图像处理	计算机软件+图像处理,FPGA工程师 硬件工程师
TRIBON绘图	建筑设计或销售
windows 系统	设计工程师
PowerDesiner15/12	软件工程师
Linux/UNIX操作系统：	软件测试
丰富ASP.NET开发经验	sharepoint开发工程师
保险资格认证	保险公估人、金融行业的职位、会计,文秘、方案策划、行政管理、人力资源管理,农险部内勤,模特经纪人,副总经理,大堂经理（见习）,银行 外汇 交易 分析 基金 管理 量化 ,出纳，会计，银行柜员，银行大堂客户经理。
质量应用软件	质量经理
PRO/E 4.0	生产经理
熟悉office等办公软件	语文教师
数学软件	客户经理助理
Web开发框架(SSH/Grails)	软件开发工程师
Microsoft office办公软件	实习生
金蝶财务软件的应用	助理
服装设计	设计师助理,兼职导游
STM32	硬件工程师
一般图片处理软件	项目客服专员，业务客服专员
WORD、EXCEL	编辑
销售支持	销售 业务,行政主管
CSS (层叠样式表)	商务助理,软件工程师
oracle数据库操作	软件工程师
prol-e	行政类
AtuoForm	冲压工艺工程师
英语四级	客户经理,会计,经理助理,管理培训生,软件工程师,会计助理,技术支持,日语翻译,行政助理,人事行政助理
培训培训师	人力资源 招聘 培训
计算机英汉文字录入证书（初级）	银行柜台人员
shell脚本	 运维,项目经理
网络、操作系统、数据库、中间件等知识	软件测试工程师
Research Operating Systems	前厅接待
波斯语	海外工作
系统集成	Program Manager
Ideas	产品开发工程师
ｆｌａｓｈ动画	FLASH
熟练掌握Linux网络安装、配置、日常管	运维工程师
sqlserver mysql orcl	java软件工程师
国家英语六级 	人力资源岗位
PS基本图片处理	电子商务专员
硬件故障	维修车间主任
精通html、div+css布局页面兼容	网站美工
德语	实习工作人员,Customer Service,董事长助理,新媒体及市场助理,Senior Market Analyst,德语教师,德语教师，德语翻译，德语助理。,行政/后勤/文秘、翻译（口译与笔译）、教育/培训、销售支持/商务、销售管理
word	工程师,会计,网站编辑,会计助理,平面设计师,市场推广主任,人事,预算员,审计主管,产品专员
arm9	嵌入式linux驱动层
lamp环境部署	运维工程师
Mock Up	产品经理助理,产品经理
Network-Routers	视讯事业部.POLYCOM售后工程师,经济分析,数据测试工程师,运营总监、部门经理,高级技术经理/支持工程师
html，css，js，ajax，jqu	java软件工程师
Microsoft ASP.NET (Active Server Page)	软件工程师,软件开发工程师,.net软件工程师,系统架构师,软件研发经理,.NET软件开发工程师,高级软件工程师,VC软件工程师,java开发工程师,软件开发初级工程师
linux操作	oracle数据库管理员
X86，ARM，AVR等体系架构	单片机开发工程师
局域网网络	电气主管
sketch up	室内设计师助理
Windows Develop-Visual FoxPro	销售代表,实习编辑,公司业务柜员,高级软件工程师,采购专员,人事主管,英语翻译 人事总务 项目助理,IT技术总监，IT项目总监，IT 总监,销售
chemdraw	研发
DOJO	JAVA软件工程师
用友软件	会计助理,会计,会计主管,出纳
计算机国家二级	销售
计算机网络	网络工程师,电气工程师,网络管理员,销售代表,技术支持工程师,软件工程师,产品策划,嵌入式,系统维护员,高级软件测试工程师
AUTO-CAD	电气工程师/技术支持工程师/检测员
Web Servers	软件工程师
沟通技能	销售代表,杭州区域客户经理,行政人事总监,项目翻译、行政、外贸,预算控制分析,大学教师或咨询顾问,数据分析师、金融、人力资源、数学教师,审计，财务类,销售零售经理,行政/专职司机
Delmia	仿真主管
ERP-J.D. Edwards	审查凭证、校验凭证
软件的测试	软件实施专员
OFFICE套件	西班牙语翻译
项目协调	新能源汽车；项目经理
Autodesk CAD	室内外装饰装潢设计
SQLSERVER	软件工程师,外语教师
WORD、EXCEL、POWERPOINT	秘书、助理、人力资源
PPT,EXCEL	外贸专员
Jsp	程序员
办公系统	办公室主任
Unix/Linux/BSD Develop-C	WLAN AP 软件开发,嵌入式软件工程师实训生,软件开发,软件工程师,Product Sales Dirctor,CDN cache部分研发,产品销售总监,C/C++软件开发工程师,驱动软件工程师,linux软件工程师
与人沟通，	信贷经理
cadence	硬件工程师,工艺工程师
SOLDWORKS	研发主管
Perl编程语言	软件工程师,技术支持工程师,数据分析师
WORD/EXCEL	研发员
FPGA	软件开发工程师
flash动画设计	网站编辑
程序员二级	律师
报告技能	用户体验研究/设计咨询
管理流程制定	网络管理员
工程技术	质监站副站长、检测中心主任,土建工程师,产品经理
ansys	液压工程师,结构力学工程师
投资管理	总裁 总经理 副总裁,物流供应链总监/经理
软硬件集成	硬件工程师
HTML、CSS、JS	web前端开发
AI图像文件编辑	结构工程师
高级办公自动化	学生
Affter Effects	平面设计
嵌入式Linux系统	嵌入式系统工程师
C&C++	Java工程师
Mind-manager	产品经理
CATIA CAD（计算机辅助设计）	机械工程师,机械设计工程师,助理工程师,咨询顾问 项目经理 法语,机械工程师、车用电器工程师、汽车灯具工程师,工程师,非标机械工程师,汽车类,白车身工程师,车身设计工程师
EPLAN Electronic P8	电气工程师
CAD / CAM (计算机辅助设计/计算机辅助制造)	机械设计,机械设计工程师,技术员,机械工程师,应聘行政人事、资料员,技术支持工程师,工程师,周末兼职,见习技术员,销售
使用SQL数据库及Oracle数据库	软件测试工程师
自动化	手机自动化工程师
SS2H框架	java软件工程师
CFX	研发工程师
TCP/IP网络编程	软件工程师
Adobe Indesign	设计师
用友BQ（商业智能平台）BI分析	移动应用研发
java传统开发	android开发工程师
Office word,excel	土建造价工程师
office	机械工程师,CAD绘图员,工程师,电商、管理、外贸、营销类均可,软件工程师,设备主管,项目管理,网站运营,土建工程师,造价员
css+jquery+html	php程序员
数据挖掘	产品经理,数据分析 数据挖掘 搜索研发
MICROSOFT OFFICE 2	拓展总经理
SQL Server2005	java 程序员
Design/Media-Authorware	UE 交互工程师,导演
premier、photoshop、AE、edius	影视后期制作
Allegro电子线路软件	NPI工程师
广西计算机一级	研发员
oracle，mySql数据库	程序员
木工	土建/结构工程师,综合维修、司机、销售、普工
NSUserDefaults	ios软件工程师
DB2	实施工程师,高级业务专家,产品经理,软件实施工程师,技术支持
51单片机	电子工程师
HTML5/CSS3	前端开发工程师
SAI	插画师
c,c++	软件开发
C/Python	数值策划
分子生物学	不限
Office Applications-Word	人事专员,项目经理,实习生,会计,客户经理,行政助理,总经理,副总经理,财务,区域经理
证券	职员
servlet	java开发工程师,Java软件开发工程师,java程序员,JAVA开发,java开发软件工程师
PRO	机械设计员
ERP操作	运营中心,出纳
CAD及OFFICE	结构设计师
Unix/Linux/BSD Devel-Shell Scripts	软件工程师,海外技术支持工程师,测试工程师,Developing Engineer,系统需求设计师,J2EE工程师,信息总监CIO/技术总监CTO,unix,后台开发工程师,DBA数据库管理员
欧姆龙、台达PLC	技术工程师
JScript	软件工程师
SAS	数据分析师,会计,理财顾问,无,薪酬绩效类,金融研究员,数据分析员,测评师 数据分析师,营运副经理,分析
回归测试	软件测试
SAP	行销企划,会计助理,linux应用工程师,工业工程,运营管理,Market planning and Administration ,大客户专员,财务审计（实习生）,财务经理,财务控制
掌握常用SOCKET网络编程技术	linux软件开发工程师
计算机应用	销售总监
基本数据结构与算法	IT审计
eclipse和tomcat	java程序员
网络管理	网络管理员,运维  技术支持 网络管理员,网络工程师,网络管理,软件工程师,全职,工程主管,信息技术主管,网络工程师 网络管理员,部门经理
solarwinds	中国光大银行
Boost库	高级软件工程师
Simulation	结构工程师
sqlserver2005	软件实施工程师
Windows Develop-Java	软件工程师,软件开发工程师,软件测试工程师,java软件工程师,java程序员,java开发工程师,软件测试员,项目经理,产品经理,测试工程师
sqlserver2008	javaee程序员
spine骨骼动画	c++客户端
Flash Builder	flash as3.0编程
能力成熟度模型集成 (CMMI)	技术总监
数据库方面的工具：oracle	高级咨询顾问
C(C++)	能源化工
AutoCAD中级证书	生产技术处工程师
金蝶K3	采购经理
Unix Shell编程	软件工程师,助理软件工程师,测试经理,hadoop  运维 架构,云计算 / IT工程师,高级软件工程师,C/C++软件开发工程师,研发工程师
CoreJava	java软件工程师,android 软件工程师
PROE5.0	工程助理
驾驶执照c1	市场营销
国家计算机二级（C）	化工制药类研发、化工生产设计工程师
公钥基础设施(PKI)	项目经理
用友 U8	高级财会主管
对日常数据的管理和维护	土建施工员
Web Develop-HTML	软件工程师,产品经理,.net程序员,高级软件工程师,软件测试工程师,java软件工程师,项目经理,.net软件工程师,技术支持,软件架构师(J2EE方向 Gis/数据挖掘)
绩效考核	行政人事部主管
Modelsim	FPGA工程师
单元测试	软件测试工程师
Rhino	工业设计,工业设计、造型设计、创意设计师（汽车外观创意设计优先）,市场专员（助理）
CSS、JS、Jquery	sharepoint 工程师
protel	助理工程师,电子工程师,客服工程师
MS offices系列软件	数据分析
c#语言	c++软件工程师
Proe	项目助理\专利助理
托福证书	国际业务中心实习生
R project	市场研究员
Database-MySQL	软件工程师,项目经理,技术经理,Project Manager,高级软件工程师,开发工程师,高级项目经理,软件测试工程师,java软件工程师,软件开发工程师
鲁班安装计价软件	建筑电气工程师
英语六级  计算机二级	硬件工程师
Pcgive	实习生，实习珠宝鉴定师
熟悉PLC  	电气调试
LabView	测试部经理，项目经理
CAXA制造工程师	项目主管工程师,机械/结构工程师
物理学	总经理/副总经理
Windows Develop-MFC\/ATL	高级软件工程师,项目经理,软件开发工程师,软件工程师,高级研发工程师,技术总监,VC开发工程师,程序员
汽车工程	销售代表,汽车销售
css3+html5	web前端开发
Windows Develop-Visual C#	项目经理,研发中心副总监,QA Lead,项目总监,需求分析 咨询顾问 售前工程师,高级测试工程师,软件测试工程师,技术专家、模块设计师,产品总监,实习生
ado.net	软件工程师
遥感和GIS软件	技术支持工程师
Windows Develop-C++ builder	电子商务事业部副总经理,技术经理,射频工程师、硬件工程师、测试工程师、研发及技术接口人等相关工作,游戏事业部运营总监,分公司总经理,C++高级软件工程师或C++项目主管
动画软件	插画师
Word	销售代表,财务助理,投资经理,测量员,产品首席架构规划师,会计文员,生产计划员,项目经理,酒店总台,品牌设计师
PC (个人计算机)	技术研发人员 临床监查员 生物制药等,跟单翻译,银行柜员、客户经理
擅长stata数据分析	市场研究分析师
Socket网络编程	嵌入式开发工程师
mysql sqlserver	java软件工程师
VS2010	C/C++软件开发工程师,会计,软件开发工程师
硬件维护	it部经理
ASP	网站运营经理,英语翻译
桌面/办公软件（精通）	实习生（市场/策划/人力资源方向）、管理培训生/储备干部
ssh集成开发	java程序员
JBPM工作流，能完成常见工作流业务开发	java工程师
商业管理	大区总监
Windows Server2008	 软件实施工程师
测试理论	软件测试
PLSQL	Linux下C/C++的开发
金蝶	出纳,会计/会计助理,会计,网店运营编辑类,研发助理
lumion	效果图
XML编辑器	产品经理 用户研究 产品运营
Microsoft SharePoint	高级软件工程师
TD，Bugfree	软件测试工程师
Altium designer、CAD使	软件工程师
midas civil	项目经理
SSH	软件工程师,软件设计架构,项目经理,软件实施,java软件工程师
SQL&oracle	CIO，IT经理，信息化项目经理
HTML编辑器	国际化推进部部门助理
进口/出口	项目主管/设备主管
Web Develop-ASP	前端研发工程师,兼职市场营销,系统分析师,ORACLE开发工程师,校长,数据统计分析工程师,信息中心经理,软件测试工程师,区域经理,销售工程师
office操作软件	水利技术员
熟练XML和JSon两种数据传输格式	ios软件开发工程师
maya建模软件	flash动画师
3、熟悉Html、CSS、JavaScr	Java软件工程师
RS485 Modbus等协议	嵌入式软件工程师
Microsoft Project Server	软件测试
OpenCV	技术总监\项目经理\技术负责人\算法工程师\研究员
Asp.Net Mvc3	.net软件工程师
ＯＡ办公软件	计划、跟单、助理
行政管理规划	人力资源总监
线下营销活动	策划师
编程、数据库	软件设计师
C开发	软件工程师
JSP、HTML、javascript	Java软件研发工程师
Google Sketchup	设计师
Hibernate的ORM	java初级开发
jsp、servlet	JAVA工程师
统计学	英语外教,人力资源&教师
oracel	产品经理
struts	Java开发工程师,软件工程师,java软件工程师
软件实施	管理、设计 、置业顾问
护理	护士,服装设计师 服装设计师助理
OpenCv	图像处理工程师
loadrunner、TestDirec	咨询顾问
Microsoft .NET	软件工程师,开发工程师,软件开发工程师,市场主管
国家计算机二级	产品机构设计工程师
SQL Server、HTML	国内贸易人员
环境工程	环保,实习生
Div+Css	asp.net程序员,.Net程序员
Help Desk-Windows NT\/2000 AS\/2003	技术支持,信息管理,综合部,系统工程师
GUI	C/C++工程师
Android，java	Android软件开发工程师
计算机硬件	项目经理,软件开发,单片机,软件测试工程师,java软件工程师,测试工程师
C/C++	软件开发工程师,嵌入式软件工程师,Java工程师,技术支持工程师,软件工程师,ios软件工程师,JAVA软件开发,java工程师,cocos2d-x开发,软件测试
社保系统，劳动与工资系统	人事专员   
Maple	电子工程师、电气工程师、电力电子工程师
造价软件	土建工程师
SqlServer	ios开发工程师
教育学	英语教师
操作系统	软件测试工程师,软件开发工程师
Oracle	软件工程师,项目经理,软件测试工程师,Java程序员,Java开发工程师,.NET高级工程师,开发测试实习生,Java软件工程师,产品经理 开发经理,项目经理/总监
IOS SDK	iOS移动开发工程师
后期制作	商务经理
andriod	数据库程序员
英语A级   	化工总控工
OA 自动化办公系统	办公室主任、运营经理、oracle ERP实施
C++、STL	软件工程师
三级数据库技术	报关员
设计	经理,设计师,设计主办,设计师助理,管理
熟练microsoft office	行政专员
信用分析	私募，资产管理公司，股票及市场分析，债卷承销
UIkit	IOS研发
office系列软件	土建工程师,鞋类产品开发方向
MongoDB	Java高级程序员
普通电脑问题处理	总裁助理
project	工程部经理 工程副总  ,实习生
用友NC	ERP实施顾问,财务or外贸,咨询实施顾问
Qlikview	项目经理
gcc / arm-linux-gcc	嵌入式开发工程师
配音	主持人
ModelSim	硬件研发主管
Hardware-Mobile Phone	硬件工程师,软件架构师,技术员，设备管理，机械设计、压力容器设计，流体机械设计，换热器设计，助理工程师，设备维护，化工机械,高级软件测试工程师,helpdesk 工程师,开发测试工程师,软件测试主管,开发处  主板EE,外贸专员
熟练操作autoCAD	兼职
ERP分销软件系统	营销总监
linux应用编程	嵌入式软件工程师
R language	金融类以及营销类
ant项目构建	Java高级工程师
熟练Office	产品设计，工业设计，结构设计
天正建筑制图	施工员
微软商业服务器	信息技术主管
WinForm	技术经理/主管
SQL sever 数据库	测试工程师/实习
SNMP协议	软件工程师
AutoCAD操作	景观方案助理
-	嵌入式软件工程师,生产管理,机械工程师,工艺工程师,会计,软件开发工程师,对公客户经理,市场运营,CAE/FEA/有限元分析,软件研发工程师
DIV+CSS、Table	java开发工程师
SAP等ERP软件	营销策划助理
DIV+CSS	网络管理员,软件工程师,网站运营
Qt	程序员
软件开发语言	技术支持经理
笔记本电脑硬件	技术支持工程师,电子工程师
Design/Media-Flash	网站编辑,市场经理/总监,技术支持工程师,精度管理,设计员,项目运营,渠道经理助理,产品经理,设计总监,FLEX PHP 高级工程师
CorelDRAW、AI	材料相关
MSSQL、MySQL、Oracle	实施工程师
VISUAL STUDIO	ASP.NET开发工程师,需求分析
.net, c#	项目经理
基本面分析	Analyst
AXURE	产品经理,产品专员,电子商务,产品经理实习生,电子商务运营经理,网站策划,android开发工程师,ui设计,电子商务经理,产品专员/市场营销/文案策划/互联网
C# 熟练	.net
金蝶、用友	会计
项目管理知识体系(PMBOK )	技术经理
java web 软件开发	软件工程师
Office Applications-MS Excel	实习生,会计,总经理,工程师,销售经理,项目经理,产品经理,咨询顾问,助理工程师,销售
OO、UML、设计模式、SSH、REST	资深java工程师
QT	C,嵌入式工程师
金融服务	项目经理,微小贷款客户经理
设备和维护	设备经理,设备维修,实验室主任助理,设备管理
Java Script	php程序员,开发软件工程师
销售软件	售后维修工程师
可靠性工程	可靠性工程师
PDM	结构设计
嵌入式操作系统	嵌入式软件工程师,软件开发工程师
Offices系列办公软件	土建施工员
QC	质量/测试经理,软件测试,软件测试工程师
Operating Systems-AIX	咨询师,IT specialist,投资经理,软件工程师，高级软件工程师,IT技术支持,db2,系统管理员、DBA
化学分析工（中级）	化工实验室研究员/技术员
网络通讯、JSON解析、HTTP协议、数	Android软件开发
ORACLE	数据库开发,项目经理,银行业务测试,初级软件测试工程师
地理信息系统 (GIS)	软件工程师、WEB前端开发
掌握运用Spring、Struts2、H	java软件工程
MAGMA模流分析	工模部
c语言程序设计	机械电子，工业自动化
渠道支持	区域销售经理
网络维护	电子商务,企业管理,数据部管理员
Flash	C++软件工程师,工业设计师，平面设计师,UI设计,淘宝运营助理,网站制作,编辑,游戏原画,行政/文员助理,农业产业化企业,网页设计
法语水平认证	行政文员
路由、交换、防火墙技术	高级网络工程师
Windows Develop-COM\/DCOM	MPLS Software Engineer,高级工程师,软件工程师,技术经理,售前技术支持,产品主管
网络分析仪	Digital VLSI (IC) Design / Layout
ADO.NET开发	高级软件工程师
J2ME	java软件开发工程师
注册税务师	CFO,审计总监
J2EE企业级开发框架	高级JAVA软件工程师
熟悉数字图像处理算法及其应用，具有图	研发工程师
Visual	Linux驱动开发工程师
开发和维护客户	销售经理、区域经理
Struts Hibernate Spring	java软件开发工程师
测绘	技术工程师
双色成型	生产经理
翻译服务	bid support specialist,英语教师、外企职员,翻译 助理,行政；翻译,翻译、市场营销类、国际贸易与实务类、人力资源类、销售类、管理培训生、营销类,海外销售主管,英语,英语翻译 英语教师 外贸专员,翻译,翻译，教育培训，销售
windows OS	IT工程师、系统（含集成）工程师、网络管理、运维、网络、技术支持工程师/经理
OS- windows 7/8	项目执行
Operating Systems-LINUX	软件工程师,软件测试,产品经理,嵌入式软件工程师,技术主管,android软件工程师,软件测试工程师,数据库管理员,软件开发工程师,网络管理员
C语言、C++	数据库工程师
Windows Server	ERP实施顾问
儿科护理	翻译，外贸，医学类
OrCAD	电子工程师,技术总监
熟悉 操作系统WINDOWS/LINUX	售前、网络安全、网络工程、安全
产品开发方法	产品  软件  支持  开发
dw	网络设计主管
3D动画图形	室内设计师
绘声绘影，iebook，PS	活动策划
计算机辅助设计（CAD）	市场开发部业务主管
Cocos-2D	cocos2d
熟练操作OFFICE等办公软件	呼叫专员
犀牛、3dmax、skehup	设计
CADD （计算机辅助设计和制图）	机械工程师,土建工程师,工程师,消防员，驾驶员,项目管理,管理岗位 设计岗位,文员 平面绘图,现场施工员,结构工程师,CAD
Web Develop-DHTML	运维工程师,事业部技术总监（TD）,实施顾问,java web 程序,测试工程师
SDL Trados	英语翻译
Matlab语言	嵌入式工程师
OFFICE系列办公软件 	产品助理
银行从业资格  	金融财务职位
AVR 单片机   	电子工程师
c++，java等编程语言	软件工程师
CAD软件画图	电气工程师
HTML、CSS、JavaScript	java软件工程师
ssh三大框架	java程序员
ILLUSTRATOR	人事经理
CAD  SOLIDWORKS	机械设计工程师
mysql	软件工程师,软件测试工程师,java程序员,软件开发,实施工程师,PHP程序员,前端工程师,测试工程师,php程序员,JAVA软件开发工程师
安装 - 暖通空调	暖通技术员
Database-Interbase	Product Management
测试分析和测试设计	软件测试工程师
软件测试理论知识与方法	自动化测试工程师
中华人民共和国职业资格证书（网管中级）	人事主管
Android	软件工程师,android软件工程师,软件开发,Android Developer,Android软件开发工程师,iOS软件工程师,高级技术经理,软件工程师、javaweb开发,高级Android开发工程师
Tcl/OTcl,gawk	软件开发工程师
ISO 14001	环保工程师；环境安全顾问/咨询；环境健康安全（EHS）工程师,营销培训管理、人事行政管理 综合管理
无线通信	企业中高层管理岗位
熟练操作PRO/E	模具设计工程师
dialux	研发部    光电子工程师
3dmax	设计师,室内设计师,项目助理,企划总监,UI设计师,三维设计
成本管理	会计主管
UG5.0	连铸工艺工程师
java软件工程师	java软件工程师
biee	数据库开发
计算机与网络技术（TCP/IP协议、网络	销售
全国计算机二级	软件测试
数据库管理软件/系统 (DBMS)	软件工程师,销售经理,IBM市场数据分析师
C	软件工程师,资深电子工程师,软件助理工程师,会计,unity游戏开发,Development Engineer,Android开发工程师,Android程序员,java软件工程师,游戏策划
金融学	各种,会计助理
UC编程	程序员
全国计算机NIT证书	会计助理
法律法规	法务专员、合规专员、律师,区域经理/销售工程师,法务 人力资源  销售,人事行政专员,企业法务专员 人事助理 银行金融机构综合管理人员,投资银行业务；律师/法务/合规
Ｃ语言	软件开发工程师
Bar Code系统	仓库管理
svn,Spring MVC开发	java开发工程师
My SQL	实施工程师
Firework	UI设计,产品经理
Lunix	项目实施,java软件工程师
html5	产品经理 需求分析 开发 测试
Microsoft IIS网络服务器 (互联网信息服务)	.net 软件开发，ERP,软件测试工程师
Socket网络编程、TCP/IP协议栈	嵌入式C开发
驾照(C1)	车间主任，现场管理，采购
particleIllusion3	flash工程师
办公用品管理	文员、经理助理、财务助理
SSH(Struts2+Spring+Hibernate) 	java工程师
corelDRAW	总经理助理,服装设计助理
预算管理	高级咨询顾问,高级软开
品牌推广	试用
广播电视系统	图像处理
Sqlserver	android开发
Nagios	linux系统工程师+数据库管理员
edius	影视后期/广告制作,影视后期制作,分镜 原画 漫画 插画 漫画编辑
JDBC,DWR	JAVA高级软件开发工程师
Cocos2d	IOS游戏开发工程师,软件工程师,ios开发,IOS应用软件开发,IOS开发工程师
http协议，HttpClient从网络	Android 开发工程师 
SQL数据库	软件工程师,软件测试工程师,Java工程师,校园大使,数据库管理员,date cleaning,测试工程师,实施工程师,计算机相关专业,windows开发工程师
MS Visual Studio	图像处理
RCSP (Riverbed)	项目经理
ARM汇编	嵌入式软件设计
word、excel、ppt 办公软件	会计
IT运营	售前
MS Sqlserver	软件开发工程师
通信软件	软件测试工程师
Unity3D游戏开发技术	Java开发
电子商务师	销售经理
日语	日语翻译,英语教师 外贸业务员 翻译,体育老师,日语翻译或物流管理相关,区域经理,客户经理,软件工程师,采购、顾问、销售,行政专员/助理 文员 教师 ,商务助理,二维动画漫画师
平面设计	平面设计师,设计师,平面设计,人力、企化专员,竞价专员、优化、美工、平面设计,美编,影视后期制作,资深设计师,总经理助理,销售管理
工艺质量	java软件开发工程师
法律事务	法务
收银	编辑 销售 客服
电子设计	电子工程师,维修工,工程师
敏捷开发管理	项目经理，架构师，技术经理
ETL	软件测试工程师
html、jsp	java开发工程师
Operating Systems-UNIX/linux	软件工程师
3D设计	设计师,设计主管,室内设计师,工业设计
网站建设软件	教育咨询师
tcp/ip	软件工程师,linux软件工程师
常用的数据结构与排序算法	C/C++软件工程师
服务器硬件	SAP BASIS实施工程师
C#	软件工程师,程序员,实施工程师,项目经理,Java程序员,软件开发,.net研发员,Android工程师,软件研发工程师,项目总监
CMM 检查	数据库管理员、ERP
俄语软件	代表处
parsley	java+flex开发工程师
二、三维制图软件（CAD、UG）	采购工程师
材料科学	工程师
Sql sever2000	软件工程师
JSON	软件开发
组织能力	人事（行政）专员,项目经理,餐饮经理、中小学教师,人事专员,实习生,渠道专员、销售代表、公关专员、企业策划,人力资源经理
MVC，DAO,SSH	java程序员
dreamweaver	网页设计制作,技术员,淘宝美工/网页设计/淘宝设计/平面设计/设计主管,各种职位,软件测试、与计算机相关的任何职位,编辑校对,技术支持,网页设计师,java程序员,电子商务/seo
Windows Sockets (Winsock)	开发工程师
solidwoks	IE工程师
C1	实习编辑,业务经理
区域管理	区域经理
Css、Html	android应用工程师
Microsoft C# .NET (C Sharp .NET)	软件工程师/测试工程师/销售工程师,软件工程师
Struts2，Hibernate	JAVA工程师
货运	船务
CATIA	电气工程师,技术管理,开发担当,汽车零件开发设计,技术工程师,产品结构设计
Linux内核驱动程序	嵌入式软件工程师
java Web开发	JAVA开发
高级中学教师资格证 	小学数学教师
考取PS平面设计师证书	新闻部编辑
STAR-CD	CAE分析工程师
管道工程	焊接工程师
熟练xml,json解析技术	Android开发工程师
游泳	建筑工,电气工程师,工业工程相关专业
Server 2003/2008	售后技术支持
天正	安装造价员,施工员、技术员
Pro/e，CAD	模具设计师
aix	主任工程师
金融衍生产品	金融 财务 会计 投行等相关行业,客户经理、客户经理助理,衍生品-期货-证劵股票
Help Desk	系统管理员
商务	商务经理
网络编程	嵌入式硬件工程师,网页设计 网站工程师,具有良好发展前景，提供员工自身积极追求，计算机专业相关的岗位      ,物流主管,软件开发员
Ofiice	市场总监
PKPM/SAP2000/3DMAX	预结算员
Windows 各系统的安装、维护和管理	网络工程师
html,css	嵌入式开发,java软件工程师
ATL WTL COM	c++
oracle数据库SQL	嵌入式开发工程师
定量分析	市场分析
采购管理	产品经理,运营总监,采购专员
各种制图软件	行销专员
化验方法	化工相关职业   助理,质量经理
Xmind	测试经理
掌握android数据库开，androi	android开发
擅长PPT制作	活动执行&活动策划
after effects	建筑动画
Office 软件	技术开发兼质量经理
办公软件、绘图软件、影视后期制作软件	技术支持工程师
能够熟练的操作word、excel、erp等办公软件以及用友和金蝶等财务软件	会计主管、财务经理
ccnp	网络、系统工程师
VC6.0	软件开发工程师
Linux shell 高级编程	软件开发
Python	程序猿,软件开发工程师,软件研发工程师,测试经理,软件工程师(C++),架构师
potshop	人事行政总监
Freescale单片机/ARM	嵌入式软件工程师
SQLserver	计算机
keil、proteus、VC++6.0	单片机助理
Sketchup	景观设计师助理,设计师,工程设计师,测绘工程师
.net(c#)	技术总监
sql sever	数据统计类
工厂管理	厂长/总监/经理
数据挖掘工具（ODM，SPSS等）	高级项目经理
熟悉计算机网络和TCP/IP 协议	网络工程师
Inventor	结构设计,机械研发 机械设计 技术支持,环保相关、水处理
VB	软件工程师,电子助理工程师,测量/计量工程师,C/C++软件开发,单片机软件工程师,嵌入式软件工程师,数据分析师,全职,机器人售后服务,嵌入式软件设计师
天顿财务软件	会计
英语等级证书 (CET-6）	私人银行客户经理
mySQL	软件工程师
微软产品应用能手证书	关务
VR	设计经理
驾照c1	行政助理
国家计算机二级证书	编辑
sql2008数据、Access数据库	.net程序员
cad,3d,ps	助理设计师
广联达	施工员,技术员,营销策划,预算员,土建造价工程师,二级建造师, 技术总监,造价员,暖通设计
java web	JAVA开发,java 开发程序员
Help Desk-MS Office	机械工程师,区域运营经理,项目经理,新疆省经理,市场调研员,CTO/COO,绘图员,系统兼容性整合测试工程师,财务会计,经理
统一建模语言 (UML)	软件工程师,.NET软件开发工程师
ACCESS	数据分析师,人事助理,管理培训生；HR
C\C++	电控工程师,Android开发工程师
计算机2级，英语4级	项目管理，质量管理，工业工程师，财会
Oracle RAC (真正应用集群)	ORACLE DBA
Micrrosoft office	产品开发工程师
绩效管理	人力资源部经理,副总,人力资源
物料计划	网络工程师 网络管理员
KEIL/IAR/MPLAB	嵌入式工程师
solaris	数据库管理员
ADAMS	研发助理
C编程语言并画出程序流程图	软件测试工程师
Struts2+Hibernate	软件工程师
Android应用开发	iOS开发工程师
用友会计软件	税务
Java 2 Platform Micro Edition (J2ME)	高级软件工程师
模具设计	塑胶模具设计工程师,模具中心经理,模具工程师、结构工程师,模具工程师,模具开发工程师
Design/Media-Corel Draw	运营总监,设计师,工程师,平面设计师,建筑方案,注册化工工程师,客服及订单管理师,机械设计工程师,产品设计工程师,艺术总监
黑盒测试	软件测试工程师,cad cam
Mybatis	java工程师,java程序员
CAD，solidworks	副厂长/管理代表
施工管理	施工员,工程师,道桥、隧道工程师,土建工程师,施工员  造价员   结构工程师,房建路桥装修施工员,工程总监,甲方代表,施工员兼测量员,施工员、测量员
华为交换VLAN	网络工程师
InDesign  AI	建筑设计师
应收帐款处理	会计、出纳
ajax/jquery技术	开发工程师
SQL( 结构化查询语言) 	电子商务
算法设计与实现	高级软件工程师
fortran	机械有限元计算
cad	施工员,工业设计,预算员,后勤主管,项目经理,技术员,产品设计师,测试技术员,景观设计师助理,人事经理
POS机	技术服务
Lotus Notes	生产经理,财务 内审,软件工程师,嵌入式软件工程师,软件测试工程师/软件开发测试工程师,经理
maya	3d design,总监
ADAMS运动仿真	断路器研发工程师
iOS	 iPhone软件工程师,Android软件开发,ios开发,资深软件工程师
Abap语言	软件工程师
测量	施工员,技术支持，产品经理，系统销售。,测量员,测量员与施工员,项目经理,土建资料员兼施工员
品牌管理	项目管理
分析方法验证	化学分析
AD10	电气工程师
Cisco	信息技术经理/主管
oracle、sql语句	软件开发工程师
熟悉Tomcat6.0	java开发
熟练使用office word、visio、illustrator、foxit 	科技英语翻译、技术文档工程师
Operating Systems-UNIX	测试工程师,IT Manager,产品经理,DBA,高校讲师/咨询师 讲师/培训／架构师/java/全文／系统性能优化,系统集成,IT技术高级工程师,associate professor,维杰思科技（杭州）有限公司,project engineer
Word,Excel,Powerpoint	设计
CCNP	网络工程师
电子测量工具	电子工程师；测试开发工程师；项目管理；硬件工程师,nslaflh1314,工程师
linux（CentOS）	仿真工程师
C语言/VC++、Delphi、java	软件测试
Web Develop-Java	软件工程师,java软件工程师,软件开发工程师,项目经理,程序员,Java工程师,技术经理,部门经理,测试工程师,软件研发工程师
需求分析软件	项目经理
unix	C 语言软件开发
电气控制	电气工程师
流程管理	企业文化
熟练使用 VC++	赴IBM软件开发工程师
餐饮管理	培训主管
熟悉Linux操作系统；	软件工程师
clementine	数据分析
用友财务软件	会计,财务文员,财务,会计 会计助理  审计助理 ,工程助理,活动执行,学生
方正飞腾	内刊编辑, 企业文化经理
Windows Presentation Foundation (WPF)	软件研发工程师
AutoCAD证书 	机械设计师
WINDOWS	项目总监,研发部主管,网络管理员
OC	iOS应用开发工程师,iOS工程师,ios开发工程师
Linux内核	软件开发
Pre/E	项目经理
Java   /   JSP	Java研发工程师
简单的Matlab语言编程	市场营销
领导能力	销售代表,结构设计师
安卓	嵌入式软件工程师
施工验收	施工员实习
WindowsServer 2003	实施工程师
计算机绘图	IE项目工程师
JMP	FA
JAVA\ANDROID	android开放工程师
Auto-CAD	品控或研发助理
rhino	产品造型设计
防火墙	IT基础架构经理
php网站开发	php程序员
uml	软件工程师
Microsoft Excel	会计助理,审计助理,实习生,管理培训生,会计,产品经理,数据分析,Java工程师,recruitment consultant,数据挖掘 数据建模 数据专员
masterCAM	机械工程师,机械设计,机械
CCNA	系统管理员·网管
Java基础知识	java软件工程师
CSS+HTML	ERP实施工程师
oracle/mysql关系型数据库	JAVA软件开发相关岗位
 SQL Server	程序员
ERP-SAP	会计主管,市场经理,IE工程师,税务会计,董事长助理兼财务总监,Project Finance Manager,工程师,物流经理,项目融资经理,品质主管
Adobe premiere	编导 摄像 后期
Verilog HDL	电子工程师
有实际的.Net项目经验,C/S和B/S	.net软件工程师
CAPP	工艺技术员,机械相关,机械设计/产品研发工程师 ,结构工程师
keyshot	工业设计师,设计师,工业设计
plc	核电相关技术，管理工作。管道，阀门设计和安装管理
QTP自动化功能测试工具	软件测试工程师
AutoCAD 文件处理	衣柜设计/CAD制图,机械工程类,设计员,电气工程及其自动化 电气工程师  安装工程师 设计 成套设备,机械工程师,硬件开发工程师,技术人员，咨询,项目经理 项目经理助理
affter cffects	广播电视编导
通信系统	销售工程师,通信工程师
风险控制	实习律师,交易员
日语二级证书	文员 资料录入员,外贸业务员,HR,外贸,日语翻译,翻译销售,人事行政经理兼总经理助理,设计工程师
axure，viso	数据挖掘
英语教学软件	教师  银行柜员 文员 销售
t-sql	java程序员
Unix Shell	软件工程师
JavaServer Pages (JSP)	软件工程师,java软件工程师,java 软件工程师,实施工程师,初级软件工程师,ios软件开发工程师,Java工程师,ios应用开发,机械工程师,java开发工程师
windows 2003	网络工程师
税务报税系统及开票系统	会计主管
Sharepoint	项目主管
Excel，Word等办公软件	会计
供应商质量管理	供应商质量主管工程师,供应链管理经理
word  excel等办公软件	LED照明研发总监
机械设计	机械工程师,助理工程师,工程师,Senior Mechanical Engineer,机械结构设计研发管理，研发项目经理，高级研发人员,机械设计工程师,经理,销售经理,设备监造工程师,设计师
Design/Media-Dreamweaver	产品经理,平面设计师,市场专员,软件工程师,美工,助理咨询师,ebay法国销售(法国组组长）,电子商务,软件测试工程师,技术支持主管
熟练掌握数据库知识和SQL语句，熟练使用	JAVA软件工程师
ppt	人事专员,会计,生产实习,会计助理,销售代表,区域经理,安全工程师,生产管理,预算员,采购员
Java	软件工程师,java软件工程师,软件开发工程师,嵌入式软件工程师,Java工程师,java,测试工程师,软件测试,asp.net工程师/程序员,首席架构师
MCGES	硬件工程师
融资	资金财务部副部长
采购	导购,采购专员
SqlServer 2003、2008	研发工程师
abaqus	管理培训生
IT项目咨询	PMP
sql、数据库	软件测试
java web开发	软件工程师,java程序员
SSH/M	java软件开发工程师
ATA	助理工程师
CPLD/FPGA逻辑设计	硬件设计 多层PCB
AutoCAD；Pro/E	产品设计师；技术工程师；产品销售
编程语言JAVA	C++软件工程师
熟悉Linux操作系统	学生
Java Script 语言	技术员
Intuit Quickbooks	会计助理
IBM Rational ClearCase	软件配置管理工程师
fireworks	ui设计师
ATG Dynamo应用服务器	软件工程师/技术架构
PL/SQL	助理产品经理,数据库工程师
操作系统相关知识	程序员
法律文件	法务、法务经理、法务主管,法务专员、储备干部
AUTOCAD软件	机械研发工程师
Office Applications-Internet Explorer	项目经理,会计助理,仓库主管,企划主管,人力资源，咨询/顾问，广告/公关/会展，电子商务，教育/培训，项目管理,编辑,Program Director,销售经理,高级主管,项目焊接工程师
电工	电工,维修电工,电气技术员,技术员,销售管理；技工；客服及技术支持；销售人员；给排水/暖通工程,市场、营销类策划,人事主管 人事助理,机修工
Database-Database Management	开发DBA,高级软件工程师,金融数据专家,Linux 内核高级软件开发工程师,性能测试主管,财务经理,进出口部副经理,人事专员实习生,采购,程序员
ASP.NET技术开发Web应用程序	软件实施工程师
bootloader启动流程  及移植	Android研发工程师
简单图片，视频编辑软件	人力资源管理助理，行政助理，文员
数据库管理	软件研发工程师
中间件	linux运维
MathCad	结构工程师
\t熟悉MVC(Model/View/C	java软件工程师
Ajax、JavaScript	web研发工程师
Linux系统下编程	C/C++初级软件工程师
OUTO CAD	造价员
OFFICE 办公软件	人力资源管理硕士研究生
Html+CSS	JAVA工程师
MS Office	项目管理,IT工程师,主管结构设计工程师,网站运营管理,SQE
linux 服务器安装及维护	系统管理员
熟悉Oracle、Mysql数据库	Linux技术支持工程师
日语水平认证	日语翻译兼行政、助理、秘书,文字编改员
eji,Ibatis框架	软件工程师
SQLite	软件工程师,项目管理，高级软件工程师
Maya	设计师,模型材质,影视后期,剪辑,MAYA动画师,平面设计,校对,maya教师,模型
excei	工程部主管
Office -Excel	人事/行政专员
excel	房地产评估,活动策划,制药研究员,与电气相关的工作，电气工程师,律师助理,机械设计,日语翻译,审计助理,德语笔译,助理
MS office办公套件	给排水设计师
sybase	产品工程师
C,C++,Objective-C	IOS移动软件开发
CISP (注册信息安全专业人员)	IT管理
金碟	会计助理
富通天下	人力资源
路由交换	嵌入式软件工程师
技术/工程设计	产品结构设计工程师,从事机电/给排水/暖通等工作的工程师、设计师,工程师,土建施工员
ClearQuest	测试经理
Soliworks	设备经理
JMP/Minitab等统计分析软件	客户技术支持,
信息系统/技术 (IS/IT)管理	产品经理，项目经理，技术支持,内控专员或者主管、连锁店经理,律师、法务、合同管理、,信息系统监理工程师
会计结算	实习生,财会审计税务相关类,财务副总的助理,项目部财务科科长,会计助理,会计专员
Office办公软件 	美术教师
premier	三维动画师,编辑
Windows	项目经理,企业架构师
Oracle DB( RAC )	软件工程师
系统测试	测试工程师,高级软件工程师
高级口译资格证	财务分析&内部审计师
sql	测试工程师,android 软件工程师 ,java开发,java软件工程师,java 程序员,java程序员
团队管理	研发，技术支持，销售，助理,Software project manager,技术总监/产品总监,技术主管,测量系统主管（三坐标测量）,店长,产品总监,雅致集成房屋（苏州）有限公司,Technical Director  and Product Director,产品经理
Agilent Design Systems (ADS) Simulation	射频工程师
vmware虚拟化	技术员
Microsoft Access数据库	行政前台,投资顾问,投资理财,市场助理,金融,数据分析师、用户研究师、市场分析师、情报处理、战略咨询,高级业务分析师,人力资源管理实习生,苹果,销售支撑
PostgreSQL	高级工程师,软件测试
软件开发	软件工程师,软件开发工程师,java软件工程师,软件开发测试,软件开发,技术支持,信息技术,越南语翻译,软件测试工程师,软件工程师/程序员
企业管理	经理助理,高层管理,财务分析,高级管理,咨询顾问,总经理及总讲师,人事部主管,工厂管理/厂长/经理/主管/销售业务,副总经理,厂长，生产经理,行政经理 办公室主任 总经理助理
c1驾驶证	综合主办
测试自动化	测试工程师
Operating Systems	Technical Support
Excel、Word、PPT等	电气设计
MSSQL	DELPHI 程序员,项目经理
Prince2	IT经理，项目经理
SAP GUI	BW 顾问
行政管理体系	人事行政主管兼CEO助理,办公室主任
分布式架构	系统运维工程师
framwork	程序员
ERP MES系统	总经理
律师助理	法务助理,法务专员 律师助理
java，网络	安全工程师
informix	系统工程师
flsh	插画师
Matlab数值分析软件	结构工程设计师
linux c	linux
Javascript	WEB前端开发工程师,项目经理,信息管理员,程序员
艺术设计	雕塑教师、雕塑设计师,平面设计学徒
维护-电器	工程经理
orcale	java工程师,JAVA开发
office，autocad	一般职员
spss软件	采购助理
建筑工程	施工员,合伙人
office word	弱电工程师
政府机构	培训主管 培训专员
外贸单证	外贸跟单员
PHP程序编写	网页设计师
HTML,js,jsp,jQuery	Java软件开发工程师
Office Applications-OutLook	生产经理,行政主管,软件工程师,品牌管理专员,销售管理、高级管理,文字编辑,linux运维工程师,市场主管/市场经理,人事行政专员,管理
office,cad	制造工程师，工业工程师
c++,c,java等	*java*
WebLogic、Tomcat、svn等	java后台开发
erp	管理培训生,行政助理
ERP / WF	总經理
网络布线	网络管理员
Python编程/脚本语言	软件工程师,软件开发/测试工程师,软件测试工程师,Senior_QA,开发,数据分析/数据挖掘
linux开发环境	IC设计工程师
熟练掌握JavaEE流行框架的使用并分析	软件工程师
员工关系管理 (ERM)	行政人事主管/办公室主任,培训主管
握多进程、多线程编程	硬件开发
Ajax ,jquery等js框架	java实习生
After Effect	影视后期制作
数据库SqlServer\Oracle	网络工程师
培训体系建设	培训师/培训专员,指导教师
Silodworks	机械工程师
C++/C#	游戏测试
office ppt	安全管理
javascript脚本	java程序员
Android UI开发技术	安卓程序员
文档制作	实施顾问相关
Windows Develop-Visual Basic .net	采购或销售总监或经理,产品经理,工程师,企划总监,嵌入式软件工程师,软件设计、测试/网络管理,高级软件工程师,ceo总经理,技术总监,网络总监,运营总监
PS、AA、Adobe InDesign	对外汉语教师
OutLook	咨询顾问
MS Word	技术支持/服务,产品经理
企业服务总线(ESB)	java软件工程师
oracle mysql	java软件工程师
eclipse	高级软件工程师,Android应用开发工程师
C,python	产品经理
Tableau	数据分析师
gcc、g++、vi等开发工具	高级软件工程师
铸造	铸造工程师
Hibernate框架技术	java软件开发员
熟悉TUXEDO交易中间件发布	项目经理
MCITP	IT服务经理
软件架构	高级软件工程师
CATIA P3V5-R19	机械非标设计
软件管理	销售、业务、电子商务
统计学软件SPSS	视工作性质而定
界面设计	交互设计师，产品经理，美术主管
HTML、CSS、DIV+CSS	java软件工程师
Multisim	风能、太阳能、变频器、纯电动汽车、混合动力汽车用直流滤波电容器研发经理,硬件工程师
新华斯维尔	预算员
掌握个人计算机的工作原理及逻辑组成和物理	店长
Protel99se	电气工程师,工程师,单片机开发、单片机编程,单片机工程师,电子信息类及测控系相关,电子工程师
PE、PR	游戏策划
Office工作软件	集团战略发展部 产品及编辑专员
3D Studio Max	平面设计师,外贸,美工设计 UI设计 三维设计,室内设计,软件测试,园林设计、施工员、室内设计、工程预算,后期制作，模型，设计。,特效师
广告, 公共关系	市场经理、品牌经理
vs2008	c/c++软件工程师
数据库设计以及SQL	Software Engineer
面向对象的编程(OOP)语言	软件工程设计师
Office Applications-OutLook Express	销售经理,生产经理,人事专员,会计,外贸经理、外贸主管、外贸业务,物流控制,办公室秘书,财务经理/财务主管,公司商务中心助理,保险部实习生
Struts2	java,Java软件工程师,需求工程师,软件工程师,高级软件工程师,Java开发工程师,java程序员
Linux C编程	软件测试工程师
3dsMax	工业设计
客户支持/服务	营业员,AE,销售代表，电子商务,财务,客服工程师,客服、前台,呼叫中心项目主管,客户经理
QC/JIRA/TestLink测试工具	软件测试工程师
C、C++	软件工程师,java程序员,ios软件工程师,DSP开发工程师
EXCEL,WORD等	经理助理，秘书等
VMware	系统工程师
Gnu Make	软件工程师
word,excel,ppt	实验员，研究员,会计
内部控制	财务总监、经理
普通话水平认证	无,会计助理,客户服务专员,文员 内勤 客服 营业员 销售等,平面设计师,HR,设计师，设计师助理,律师助理,外贸助理/外贸专员/业务跟单,设计师
Auto CAD软件	技术类
vb.net	软件研发工程师
Struts / Hibernate /	android
仓储管理	物流仓储主管,物流/供应链主管,业务主管,采购/销售/贸易
弱电设计	销售工程师,弱电销售
JAVA基础 	java软件工程师
3.曾写过html5页面；可以提供htm	web前端开发、网页设计
MS	Marketing Assistant,财务会计、社会审计,Process Engineer
sql servver, mysql	java工程师
Mastercam	机械工程师,区域销售
UG（NX）	结构设计工程师
CAD二维制图	电机工程师
LoadRunner	软件测试,软件测试工程师,测试经理
Axure、Visio	网站产品经理
fastdfs	数据分析师
.Net Framework	软件工程师,linux运维工程师，linux开发工程师,程序员
中级程序员	电子商务
项目管理	项目经理、技术总监,工程总监,管理培训生,PM / PR / MKT,技术部主管/自控工程师/项目技术支持,实施顾问,工程副总、总工程师,经理,销售经理,测试经理，项目经理，项目总监，产品总监
质量控制	水电工程师,产品经理,质量经理,高级管理,质量工程师,测试工程师
原子吸收光谱法	工艺研发工程师
机电学	工程部主任
Database-Access	软件工程师,高级软件工程师,项目经理,英语翻译,技术支持,派单  销售,稽核员,渠道主管,财务类或ERP,无
PROII	化工工艺工程师
计算机三级	技术员
cad，3d，手绘	设计师
三维算量软件应用	造价员
redmine测试管理工具	软件测试工程师
Bugfree	软件测试工程师
FoxPro 数据库	Finance
写作技能	网络管理员,组训岗,会计主管,策划、文案、人力资源、公关,文秘，助理,销售,行政经理或人力资源经理,语文教师,音乐编辑,环境 化工 农林牧渔 管理
电脑技能	项目经理助理--总工、项目总工、生产经理
Makefile的编写	嵌入式软件工程师
编辑	体育新闻编辑,行政、外联,助理,行政助理,翻译,企业文化、企业宣传、记者
广联达、斯维尔	土建工程师
HYPERMESH	CAE经理
justep X3	项目管理
熟练使用游戏编译器（CocosBuild	IOS开发工程师
心理咨询	客户关系管理
visio	技术员,策划（UX UI）,产品经理,实习生
CAM 350	高级硬件工程师
视频制作软件	人事助理
WINFORM	.NET开发
pscs2	专卖店设计
PhotoShop	3D美工,环评技术人员,iOS开发工程师
JavaScript	软件工程师,java软件工程师,java软件开发工程师,软件测试工程师,Java工程师,项目经理,软件测试,软件开发工程师,高级软件工程师,软件研发工程师
python	运维工程师,安全工程师
mySql数据库	java程序员
AOTU CAD	机械设计工程师
金蝶/用友财务ERP系统	会计
现场管理 	监理员
Quartus II	ASIC FPGA SOC 技术支持 分析师 架构 FAE
Outlook	服装业务跟单
网络推广	产品专员/产品助理/初级软件工程师,企划执行,运维工程师,经理,电子商务专员,广州嘉轩包装材料有限公司,网络推广
船舶操纵与避碰  雷达操作	实习生
方案规划及架构设计能力	信息(技术)总监
Oracle ERP	客服&物控专员,销售工程师、客户代表,关务主管,高级项目顾问
DATABASE	销售总监
Dreamweaver Flash	网页设计与制作
平面设计10年经验	平面设计
Unix/Linux/BSD Devel-C++	电气工程师,软件工程师,高级软件工程师,副理,经理助理,数据采编,售前支持工程师,测试主管,产品方案,高级测试工程师
Linux环境下编程	软件工程师
liunx	网络管理员
Catia	汽车,CAD工程师
Coreldraw	用户体验设计师,平面设计,工程师,编辑
性能测试	测试经理,软件测试工程师,中高级软件测试工程师，测试经理,工程师助理和实验员
方正飞腾、大洋、EDIUS	编辑
用友U8	会计,财务会计,资金管理经理,高级财务及其相关职位,主辦會計,财务经理
HTML/CSS	java软件开发工程师
HTML Help Workshop	测试工程师
英语国家六级	税务、财务、行政助理
Weblogic	软件开发
Auto CAD 	Product Engineer
普通话二级甲等  	备件采购
pro/E	质量技术工程师,散热、热设计工程师、结构工程师,机械设计师
教师证	护理教师
office软件	水利/水电设计,数据库管理员,工程师,空乘,财务,C++软件开发工程师,人力资源部经理
时间管理	营销员,PMC经理,编辑 人力资源助理 行政管理
C程序设计	Java程序员
设计　编程	厂长助理    人事 后勤副经理
心理学	职业经理人,大客户经理、销售管理
Keyshot	工业设计实习生
c语言	软件工程师,java开发工程师,技术支持工程师,测试工程师,软件研发工程师,冶金,嵌入式软件工程师,电子相关,光学工程师,IT helpdesk
excel VBA、SAS编程	精算类
ATUO CAD	与本专业相关的工作
pro/e	机械工程师,机械研发工程师,机械设计工程师,交互设计师
数学软件MATLAB	汽车相关产品设计
办公软件	助理工程师,生产厂长,五金模具设计,技术支持工程师,软装设计助理,电气传动工程师或主管,经理,质量检验管理,总监,室内外设计师助理
雅思证书	项目经理,机械工程师,银行、金融、人力或销售相关,法务专员、咨询助理、翻译
业务跟单	广告/媒体/影视/公关/媒介/百货/连锁/零售/服装/纺织/皮革,区域经理
MSC Nastran	机械工程师
钣金设计	机械钣金结构工程师
STL	C++软件工程师,C/C++开发
通过英语CET-6	分析技术员
Mantis	测试主管
Oracle/SQL	软件开发工程师
办公室管理	环保工程师,行政/人事专员、助理,行政经理,人事助理
计算硬件维护	零售经理
Proe 三维机械建模	项目开发
助理 	技术员
su	景观设计师,景观设计师或景观设计师助理
fluent	研发工程师
Protel	电子工程师,专利撰写人,电子工程师/助理，单片机工程师/助理,电路工程师,电子工程师/技术员,嵌入式软件工程师,Equipment Engineer,机械设计相关
Corel Painter	软件工程师,视觉设计,插画，动画分镜 脚本 原画 动画 角色设计
焊接	技术员,单片机、电子研发工程师,技术工程师,硬件工程师,电子工程师,工艺工程师
数据库维护	研发工程师
VRML/VIRTOOLS/PS	开发人员、设计师、机械工程师
JS,AJAX,JQuery	JAVA程序员
注册会计师	 内审主管,人事专员/招聘专员,助理,部门经理
Data Analysis	Data Analyst / Business Analyst
Office办公软件	施工员,审核员,交互设计师,汽车线束工程师,设计主管/美术指导
Sun Solaris	测试经理
Microsoft Internet Explorer浏览器	财务 审计
MS excel	环保工程师
全国计算机等级考试（三级数据库技术）	电子工程师
ArcIMS (Arc Internet Map Server)	产品经理
ERP系统管理	计算机维护员
数字信号处理 (DSP)	软件开发工程师,研发人员,项目经验
广联达图形算量计价软件	资料员
VFP	市场专员
嵌入式开发	嵌入式工程师
AS400开发	需求分析师
单例模式、工厂模式、装饰模式	java开发工程师
硬件维修	综合维修
速达V3	会计
财务统计	客服经理
LaTeX Typesetting	数据分析,软件工程师,实习
Shell编程	C软件开发工程师
c#软件开发	工程师助理
HFSS	电子工程师,技术员
Hyperion HFM	财务分析经理
可编程逻辑控制器（PLC）	电气工程师,项目主管,技术学习,组长,技术员,检测认证工程师,单片机开发,区域经理,机电工程师,装备，维修
C和Objective-C	IOS开发工程师
JavaEE	java软件工程师
Winform	自动控制
jsp+easyui+javascrip	java软件工程师
consumer networking	客服
天正电气	项目经理
Visual C++	产品开发与试制试验,研发工程师,window软件工程师
Cet-4	研发助理
cisco认证	网络工程师
CGI (通用网关接口 )	高级软件工程师
计算机二级c语言	电子工程师
HyperMesh	机械工程师
VideoStudio	文案策划
包装设计	品牌/产品经理
工程软件	钢结构工程师
编程语言	管理培训生,软件开发
SAP BW	Supply Leader
计算机2级C语言	工艺员
Linux系统操作及其编程	全职
电路画图软件	电气工程师
Ps Ai Dw	平面设计
win32	VC
Microsoft Visual Studio .NET	测试组长
jBPM5	Java
办公室软件	人事专员,组训
css	软件工程师,php程序员,前端工程师,软件开发,Java软件工程师,java软件工程师,java 高级工程师,高级前端工程师
CCNA (Cisco Certified Network Associate)	软件测试工程师,技术支持工程师,网络工程师,市场/营销/拓展（总监）、市场/营销/拓展（经理）,网络安全工程师,技术总监,技术工程师,呼叫中心经理 客服经理,ISS部门经理,销售经理
Bugzilla	测试经理,软件测试工程师
DWDM（密集波分复用）	售前，通信，网络，销售，项目，管理
HFM	会计
PHPWind	iOS软件工程师
信息技术 (IT) & 信息系统 (IS)	客户经理,SAP 咨询顾问,游戏策划,C/C++软件工程师,技术工程师
电脑网络调试与维护	电脑技术员
ERP-SPSS	高级专员,行政人事部部长,对公客户经理,海外商务总监,管理类，运营类，研究类,技术支持,投资助理,咨询顾问,审计/顾问经理,媒介策划执行
RHINO	技术员
Lua	电气工程师；软件工程师；金融类,移动互联网产品经理
SWING	高级软件工程师
通信标准	android工程师
OpenGL编程库	软件开发工程师,游戏引擎工程师
JQuery	软件工程师
计算机日常维修	水电工程师
Microsoft Exchange Server 2003	系统管理员
设计相关的2D、3D设计软件使用	产品经理
ejb	软件工程师
indesign	印刷,营销策划,品牌,美工设计课股长,平面设计,插画师,美术编辑
Final Cut	记者（国际方向）
catia	机械工程师,产品工程师
jquery插件的使用	软件工程师
用友U8,U9	会计
VMM	销售工程师
服务器配置维护	软件测试工程师
cet4	人事主管
电磁兼容性 (EMC)	EMC/一致性测试工程师
cet6	会计
Microsoft 技巧	供应链项目经理
奖学金	市场部助理
电脑操作	服务经理 售后经理 总监,英语翻译,英语教师,新闻编辑 商务助理,采购员,高级管理会计师,销售助理,雇员,后勤
3.能够熟练应用struts、hiber	java软件工程师
ajax	软件工程师,网站建设
office办公	土建施工员
Origin、Jade、SEM、XRD、	研发工程师
jQuery	软件工程师,java软件工程师,java工程师,Web 前台工程师,JAVA开发,工程师,软件开发工程师,Java工程师,java开发工程师,java软件开发工程师
集成电路 (IC) 设计	技术研发，硬件工程师,可靠性工程师
C#,JAVA	Software Engineer
Jquery使用	Java工程师
SU，CorelDraw，lumion	设计助理
Network-ATM	研发主管 高级硬件工程师 嵌入式硬件 嵌入式系统
GDI+图形界面编程	软件工程师
Windows Develop-Delphi	软件工程师,技术总监/经理,电气工程师,证券分析师,嵌入式 电子 研发工程师,ERP工程师,总经理,信息安全经理,SFCS工程师
EXCE	网站编辑
opencv	图像算法工程师
EDA工具	硬件工程师
router	网络工程师
熟悉SVN的使用	软件测试工程师
OCP-AD Oracle Certified Professional - Application Developer	产品经理
origin	工程师
2D 绘图	美工
VB，VB.net	对日高级软件工程师
Oracle、mySql，SQL等数据库	web前端工程师
SOLIDERWORKS	材料工程师
INDESIGN	设计总监
Remedy Help Desk	网管
CFD 软件	工程师
unix/linux	运维工程师
3dx max	平面设计
设计模式编程方法	软件工程师
电话技巧	行政助理
英语等级证书 (CET)	机械设计工程师,人事专员,技术员,经理助理,售前技术支持工程师,供应链管理实习生,储备干部,合规品管岗,技术助理,店长
hibernate、struts	JAVA开发工程师
CAD制图员	销售担当
Win32 /MFC、STL、COM	C/C++程序员
Word等办公软件	土建工程师
C#语言编程基础	IOS开发工程师
专业英语八级	英语翻译,英语教师,商务经理/项目经理助理,外贸业务员,公诉一处办案组,财务主管、收购并购尽职调查员,财务方向,综合部部长\翻译,教师
SQL Server/Linq	.net程序员
Project Manage	项目经理
Delphi语言	部门经理
Microsoft SQL Server DBA (数据库管理)	数据库管理员，文员，其他,数据库管理员
3D max、Auto CAD	市场部经理
SEO	网络营销
示波器/逻辑分析仪	FPGA开发
matlab编程	数据挖掘工程师
Transact-SQL	软件工程师
基本故障排除	区域经理
CSS3	敏捷教练
能够使用Swing技术完成窗口界面	软件测试
维护 - 暖通空调	工程业务
Tomcat	java程序员,java,Java软件工程师
SW-6	设备设计
PDS	化工设计
Microsoft Visual C# .NET	项目经理,技术主管
Axure RP	网站策划 数据分析员 网站更新维护,UI设计师
MS Office word	Consultant 
CAD等	项目经理
行政管理策略	助理兼司机/销售/业务经理
IBM WebSphere DataStage	软件工程师助理
管理学	C/C++软件开发工程师,生产经理
法律行业	法律顾问,法务主管/专员,法律咨询顾问、法律经理、法务总管
硬件	设备管理维护
linux程序设计	软件开发工程师
手机软件测试 	手机软件测试工程师
熟练调试CISCO路由器的VPN应用	网络工程师
word，excel，ppt	营业助理
理财规划	经理,教务助理,培训,行政内勤、出纳
Windows Develop-UML	Business Analyst,软件开发,系统架构师,软件工程师,售前技术支持工程师实习岗,软件测试主管,部门经理、系统架构师等,java程序员,程序员
Hardware-PDA\/Handhelds	四川移动高级业务师,高级系统工程师
熟练掌握办公软件 	银行合规 法务主管 法务专员
ppt，photoshop	软装设计师
MYSQL	JAVA工程师,C/C++软件工程师
熟悉java编程	软件工程师  网络管理员 系统管理员 软件测试
VMWare	售前,系统集成工程师,IT/Network
系统架构设计	部门经理
php、html、mysql	项目管理培训生
Database-MSSQL SERVER	软件工程师,项目经理,高级软件工程师,软件开发工程师,测试工程师,技术总监,java软件工程师,产品经理,研发工程师,IT主管
酒店管理	经理助理,总经理,酒店西餐领班
Python程序开发	软件工程师
Asp.net	UI设计师
pro	机电工程师
SPIN顾问式销售	销售总监 市场总监 大客户/区域经理
BPM	 项目经理
TCP、UDP网络协议	软件工程师
网络系统硬件	网络管理员,助理
B2C 电子商务营销	电商经理,电子商务主管、电子商务经理、企业网络推广营销专员
思维导图软件	市场副总
Matlab	机械工程师,化验员,风险管理,软件工程师,robotics,研发,C++软件开发,金融研究员,模拟集成电路设计工程师,量化研究员
Hibernate,Mybatis	程序员
DoE	wu
计算机软硬件维护	IT技术支持工程师
人员管理	生产主管,呼叫中心客服主管,店长,维修工程师
AUTO CAD 二维设计	机械工程师
Design/Media-AutoCAD	项目经理,工艺工程师,设计,研发工程师,电气工程师,总经理,机械工程师,设备工程师,工程师,生产经理
j2ee技术	java实习生
会议管理	信息化管理，信息分析,主持人、播音员、配音员,行政
Windows Develop-FoxBASE+	市场主管
团队精神	银行柜员、大堂 证券公司投资顾问,产品经理,实习生
注册造价工程师	造价工程师
Dreamweaver.	平面设计
Tomcat、Jboss	java软件工程师
机械装配	技师,机械
英语六级证书  	教师  讲师
Illustrator CS3	平面设计
人际技能	Marketing Manager
用友与金蝶财务软件、sap系统	会计
IPv6网络软件	软件测试经理 高级软件测试工程师
windows程序设计	软件工程师
DIALux 照明应用配光设计	技术总监
Pro/E 三维制图	机械设计和制图
江苏省三级偏软	软件测试工程师
熟练运用用友u8软件	会计、文员、出纳
Photoshop	设计师助理,外贸业务员,行政,设计助理,机械工程师,地质矿产类总工程师,助理工程师,无,销售管理,用户体验设计师
word 熟练	财务会计 会计助理
3D-MAX	游戏文案
sql server	情报信息分析员,java程序员,java软件工程师,程序员
Android开发	项目经理
Office word	对外汉语教师
PROE、AUTOCAD	机械设计师
计算机应用技术 	技术支持工程师
3D Max	室内设计师,园林施工员
熟悉uboot等bootloader源码	嵌入式软件工程师
Div+CSS	Java开发工程师
C++\Java	软件开发人员（C，C++，JAVA，其他语言需要培训也可） 
互联网应用	外贸销售经理,销售经理
pcb设计	全职
Adobe promiere	内容剪辑
Dreamweaver	公关活动策划,编辑,市场部经理,交互设计师,策划专员,平面设计,活动推广文化传播,人力管理助理、行政助理、商务秘书、,UI设计师,人力资源助理
无线电工程	技术上的都行
Oracle，MySQL数据库，	java软件开发工程师
Word  Excel	外贸跟单 金融销售相关职位  北京,文职类
金算盘财务软件	会计助理 财务助理
Ansoft	电气工程师
Struts2，Hibernate，Sp	java软件工程师
web前端	java软件工程师
英语，计算机	市场经理
熟悉arcserver,熟悉AO库	gis开发
局域网 (LAN)	技术员
RTL 设计	助理工程师
Microsoft Visual Basic	数据分析员,运营总监
烽火认证光网络（EPON）工程师	技术支持工程师
xml	uc开发,Android软件开发,android开发工程师
UG8,0	金属材料工程师
PADS/Power PCB	硬件工程师
word excel	淘宝客服
各类上位机、下位机编程软件	电气设计工程师
Mapinfo	无线通信设计项目经理
MCDBA	水景景观
嵌入式交叉编译开发环境的搭建	嵌入式软件工程师
Help Desk-Windows 2000 Pro\/XP	系统工程师,IT主管兼行政主管,工程监理,产品经理,客服部经理,行政类,市场部经理,电气技术员（炼钢厂自动化和仪表区域负责人）,物流主管,律师
NC财务	ERP实施顾问
word、excel等office办公软	会计
CAD、Proe	机械设计、质量检验
Minitab	会计助理,咨询顾问,资深工艺开发工程师,SQE
电子设备	弱电现场工程师
大学英语六级(CET-6)	法务专员
路由交换方面	liunx系统运维
气相色谱法-质谱法 (GC - MS)	化验员 技术员 实验员 研究院,质量控制，生产管理，研发，培训生
ERP财务软件工程师	出纳
英语（熟练）  	研究员/售后工程师/质量工程师
Win32、MFC等相关的windows	C++研发工程师
mfc	软件工程师
proe、Autocad	结构工程师
ssh	项目组长,java软件开发工程师,java开发,Java高级工程师
Qt GUI(图形用户界面)工具包	软件工程师,嵌入式开发,Java开发工程师,ios 开发工程师,买手、行政、策划，程序员，测试员、培训、教师、采编、文案、广告
Excel/VBA	投资助理
斯维尔计价、 算量	造价员
Sql Server	C++软件相关开发,web前端开发
win32编程	C++软件工程师
Flex语言	java软件工程师
数据库-Oracle 	软件测试工程师
编程方法	通信工程师、系统集成、软件测试等
c++	软件工程师,Android 开发工程师,java工程师,监工,软件工程师 高级软件工程师,网络工程师,软件开发,linux驱动工程师,C/C++软件工程师,高级软件工程师
VF数据库	会计
电路组件	电子工程师
CAD制图	办公文员,助理工程师
掌握面向对象的设计与开发，熟悉常用设计模	售前技术支持
脚本语言：javascript	软件测试工程师
Photo shop	销售
Macromedia Fireworks	平面设计,产品经理,实习生
pro.e	助理工程师
word、excel、ppt等程序	副总经理
excel word ppt 	会计助理
Linux c	android应用开发
SQL SERVER	实习生,java软件开发,高级项目经理、部门副经理,ITmanager,高级软件工程师/技术经理
sql service 、oracle	java程序员
NOTES	质量主管
Lighttools	光学设计工程师
AutocAD工程制图	室内设计师 精装修设计师
熟悉单点登录及开源产品整合(UCente	php程序员
plc编程	电气研发工程师
了解Linux环境c和shell编程	java开发工程师
javascript/jQuery	软件工程师
Verilog	研究工程师
网络故障维护，中小型网络创建和管理	IT技术员
网络架构与组成	设计师
AutoCAD高级制图员	加工中心
文件和目录的各种函数的应用	linux c开发工程师
AUTOcad	施工员,研发工程师
axure RP	视觉设计师
AJAX 	软件工程师
Coreldraw, photoshop	Sourcing manager
并发版本系统(CVS)	咨询师\销售,java软件工程师
windows环境与 linux环境	软件工程师
新产品开发 	LED结构 项目工程师
CCNP (Cisco Certified Network Professional)	地市技术支持负责人,网络工程师
功能测试	硬件测试
ERP  	人事行政专员
汇编语言	电子助理工程师,电气业务员,电气设计工程师,软件开发工程师,软件工程师,调试工程师,增值服务,FAE 嵌入式软件研发,c++开发工程师,嵌入式工程师
c语言编程	工程师
JS、Ajax、JQuery	Java软件工程师
熟练运用Office软件	翻译
久其、用友财务软件	会计
VMWare环境搭建、	软件测试工程师
js	php程序员,.net 程序员
transcad	交通规划师
INTEBAS	实施顾问
SQL Server 存储过程的编写	程序员
英语六级	外贸业务员,日语翻译,人事专员,会计,人力资源主管,无,销售顾问,对外汉语教师,总经理助理,销售代表
测试知识	测试工程师
Oracle 、MySQL	java开发工程师
软件工程	软件测试师,软件工程师,senior software testing engineer,java软件工程师,程序员
LabVIEW编程语言	技术员,测试工程师,无,机械工程师,machnical engineering,软件工程师、测试工程师、管培生
熟练编写SQL语句	java开发
Web Develop-XSL\/XSLT	技术总监 项目经理,软件测试,java程序员到项目负责人
solidworks	机械工程师,助理工程师,自动化机械工程师,技术性管理类,机械设计制作及其自动化,机械设计师,机械工程或设备工程师
officer	初级工程师,电气工程师
WORD、EXCEL、PPT	机械工程师
精通photoshop	软件工程师 嵌入式工程师 单片机工程师
Win32内核编程	C++软件工程师
Office 2003	机械制造项目经理
3D max	城市规划师
电气设计	电气技术员,电气工程师
Web前端	Android开发工程师
ZigBee	软件测试工程师、技术支持
上市规划	金融行业会计、审计
网络协议	技术工程师,软件工程师,测试工程师,售前技术 项目相关,网络或通信相关职务
经济分析	实习生,公关专员/助理、公关主管
poi	高级软件工程师
熟练运用Tomcat、JBoss、Weblogic等服务器	java软件工程师
Xcode.5.x	iOS开发程序员
Office 办公软件	机械工程师,售前技术支持
商务礼仪	商务代表
Actuate报表	java软件开发工程师
VC，C++，.net，C#	软件测试工程师
ORACL	Java开发
Photoshop CS6	ui设计师
Photoshop CS5	施工图设计师
altum design	嵌入式硬件工程师或助理
ARM（进阶精简指令集机器）	嵌入式软件工程师
环境监测	化验员,检测人员、技术员
CASS	测量室主管
plsql编程	软件工程师
企业网站维护	外贸经理
sql语言	软件测试,java软件工程师,android工程师
PS软件	技术支持（生产，售后）
互联网技术	高级软件测试工程师
幻灯片制作	活动策划
visual studio操作	C#.net程序员
Microsoft Office 2007	会计,机械设计工程师,销售代表,会计 审计 财务,项目执行,erp实施顾问,市场主管 市场专员  销售主管 销售经理 运营主管,软件工程师,客服专员,区域经理
新闻报道	科技管理工作,编辑 记者
sqlsever	c#软件工程师
Microsoft Office 2003	高级产品经理,结构设计工程师,化工精英,渠道大使,律师助理商务经理,Sales Assistant,电力 电子 仪器仪表 硬件设计等相关职位,电子产品研发,(应届),研发工程师 数据分析工程师
遥感图像处理	技术支持工程师
Microsoft Office 2000	销售
物业管理	物业副总经理/总监
数据库 SQL Server	.Net软件工程师
Office办公自动化软件	高级品质工程师
广域网 (WAN)	网络工程师
计算机认证	会计,UI设计师 平面设计师 ,投资经理,南城支公司总经理,人事专员,单片机软件工程师,客服经理,嵌入式软件工程师,葡萄牙语翻译,销售
嵌入式Linux及ARM	嵌入式软件工程师
CFD软件FLUENT	CFD仿真工程师
熟练使用黑盒测试和并了解白盒测试	软件测试
工程监理	工程部经理,建筑工程管理
客户关系管理 (CRM)	销售代表,工程师,外贸专员  翻译,销售代表 业务员,组训,销售总监
电话	行政助理，前台接待
日语输入方法	日语翻译,行政助理
DIALux	施工图绘图员
InTouch（Siebel）	销售
Windows Develop-Visual C++	软件工程师,软件开发工程师,技术总监,高级通讯协议开发工程师,助理工程师,高级软件工程师,架构师 研发经理 高级工程师 C++ erlang 广告引擎,软件测试工程师,项目经理、产品经理、开发测试及软件行业相关职位,销售经理
ProtelDXP	研发 经理 主管 总监 技术,电子工程师/技术员,电子工程师,测试工程师,电子项目工程师
CIM/MES	IT Manager
农场管理	外派职员
PowerPoint	管理培训生,文员,行政专员,销售代表,行政/人事助理,渠道专员,活动策划,客服专员,行政管理,人力资源管理
熟悉Android下的短信，联系人系统	Android开发工程师
Linux应用开发	嵌入式开发工程师
AIX	数据仓库工程师,数据仓库
注册资产评估师	财务主管
CAD；天正；PhotoShop;SketchUp;InDesign	设计
驾驶C1	会计
Struts2、Hibernate	java软件工程师
cobol	高级软件工程师
MAYA	影视后期
SOLIDWORK	门窗研发
熟练使用autocad	资料员
C,C++	java研发
高层管理	模具经理
KETTLE	数据仓库、报表开发
熟悉测试体系、测试理论、测试流程、测试方法； 	测试工程师
WEB开发技术如Ajax/JSTL/	JAVA工程师
影视后期	三维动画师
html	java软件工程师,软件开发,电商专员,php,软件工程师 通信工程师,软件工程师,编辑 微博推广 行政 艺术品编辑,软件测试,软件测试工程师,java开发相关岗位
Bloomberg	二级市场分析
QC/TD	测试经理
办公软件 	人事专员/助理
js,jquery	php程序员
程序员	生产总监
项目管理project	工程总监
Android操作系统	软件工程师,android软件工程师,嵌入式软件开发,android工程师,android开发,软件测试工程师,android开发工程师,嵌入式软件工程师,实习生,Android应用开发工程师
通过国家计算机二级c考试	电气类，控制类工程师
Embedded	嵌入式软件工程师
superworks制图	电气工程师
wps	车间主任（生产主管）
solidworkshop	工艺工程师
mysql、sqlServer	软件工程师
wpf	asp.net
熟练使用word、excel、powerpoint等办公软件	会计助理 会计文员 出纳 会计
IE	Lean Engineer,IE技术员
ID	平面设计
物料分析	管理员
Windows Develop-Access	会计主管,Senior Mechanical Engineer,行政助理,product supervisor/senior product manager,产品总监,机械工程师,客服经理,高级软件工程师,综合管理部经理,审计助理
英语等级证书 (CET)6级 450分	金融 投资 方向
鲁班土建算量软件	工程预算员
MySQL数据库	高级软件工程师
编程	硬件研发工程师
C++语言	资料员,高级测试工程师
会性能测试（如：LoadRunner）	测试部
数据库数据管理	营销策划、项目管理、管理咨询职位、银行金融业、营销管理,软件测试工程师
硬件描述语言	工程师或助理
审计	审计主管,审计经理/财务经理,财务总监、税务、审计总监
项目管理（project）	高级产品经理
IAR软件	硬件工程师
Office系列办公软件	业务代表
导演	导演 编剧 剪接 摄影
C++编程语言	高级软件工程师，项目经理,嵌入式软件研发工程师,软件测试工程师
手绘板	设计主管或设计营销类
MYSQL,ORCAL	软件开发
cocos2d	ios软件工程师,IOS开发工程师
office 办公软件	客服,嵌入式软件工程师
extjs	软件工程师
广联达软件	造价员
autocad	液压工程师,机械工程师,人事经理,电气工程师助理,项目工程师,副高级工程师,无,Structural Engineer,研发岗位,机械维修
PLC编程（西门子、AB）	电气工程师
食品和饮料行业	助理
jsp,java	web程序员
pkpm	施工员,结构设计,土木工程
网页制作	会展专员
MFC (Microsoft Foundation Class) Library	软件测试开发,高级软件工程师 架构师 软件开发,IOS高级软件工程师,高级软件工程师,android开发工程师
编程工具：熟练使用MyEclipse、E	java软件工程师
笔记本电脑	客服主管
兽医学	畜禽疾病防治技术员
经营策略	重庆地区首席代表
阿拉伯语	阿拉伯语翻译,直销员,阿拉伯语翻译（口、笔）
SVN	JavaWeb软件开发,软件工程师,.NET软件开发工程师
了解Oracle,MySQL等数据库知识	JAVA软件开发工程师
Design/Media-Premiere	招聘主管/经理  人事主管/经理,工程监理,Business Controllor,三维建模人员,客服代表,平面设计,实习生,营销经理,用户体验设计,金融银行团队
TCP/IP通信原理	软件开发
安全/工作安全	项目经理/售前工程师,加工管理,审计专员
Lumion	助理
产品演示	工程师
Eclipse	软件工程师
网络安全	网络工程师,技术工程师,技术支持,前处理工艺师
XML (EXtensible Markup Language)	实习生
Project	项目经理,市场营销，质量管理,信息主管
嵌入式软件	嵌入式软件工程师,售前,初级软件工程师
AJAX	java开发工程师,ASP.Net程序员,高级软件工程师
SketchUp	景观设计助理,景观 规划设计,园林景观设计,助理景观设计师,操作员工,实习生,助理设计师,景观方案设计、景观扩初设计、项目策划
C语言	软件工程师,软件开发工程师,数通工程师,外贸业务员,JAVA程序员,SQE,海外技术,开发工程师,销售/市场/助理/零售,维修工程师
Design/Media-Adobe Photoshop	法务,网站编辑,投资顾问,印前出版车间实习生,实验员 研究员,产品开发专员,软件工程师,管理培训生,网站策划,机械工程师、产品结构设计、模具设计、工业产品设计
大型系统设计能力	CTO
1、出色的培训演讲技巧；2、组织较大规模的对外人员招聘活动；3、出色的领导能力；4、计算机技能	会计兼客服
AdobeIndesign	市场经理
多进程、多线程编程	c/c++软件工程师
Solidworks高级设计	机械设计绘图
adams	机械工程师
PADS/Protel/AD	助理工程师
UG、PROE	技术研发
windbg调试技巧	病毒分析
Dreamweave	网页设计
SQL server数据库	软件工程师
Outlook express	财务助理
宏业	资料员,造价员
Keil C	电子工程师,电子工程师助理,技术人员,DSP工程师,网络优化工程师，电子工程师，软件工程师等,嵌入式软件工程师/单片机工程师,电子工程师 硬件工程师 电子研发工程师
熟练基于开源框架下Struts	项目管理
cisco	运维工程师,无
Linux下开发	Android软件工程师
Servlet	软件工程师,java程序员
HTML，CSS+DIV	.net工程师
Struts	软件开发工程师,Java,Java软件工程师,java软件工程师
ms excel	会计
Jakarta Java Struts Framework	J2EE工程师
面向对象编程能力与设计模式	JAVA软件工程师
二级建造师	结构设计,土建工程师,技术员工长
struts1.2	Java高级软件工程师
UML	软件工程师
AE	设计师,会计,动画 后期,UED用户体验验设计,记者,广告制作
Pro/e	项目经理,移转配送
HFMS系统	会计
sispipe	给排水设计
CAD、Project	文职
软件开发方法	软件研发
Photoshop图像处理	外贸注册登记
非线性编辑	记者/节目策划及编辑/后期制作,记者,编辑记者
jsp javascript ajax	java程序员
生物医学	药品化验员，行政专员
ArcGIS	遥感影像产品工程师,实习生,java程序员
Word、Excel、PowerPoint、Visio	软件工程师/Windows Phone开发工程师
速达软件、Access数据库	财务实习生
Pro/E	机械工程师,机械设计工程师  ,机械设计师,产品研发工程师,结构工程师,制冷,工业设计师,液压、重工、机械、气动、仪器仪表等领域技术人员、工程师等职务,CAE工程师,SQE
多种绘图软件，PROTLE等	电子工程师
销售产品类型	销售主管或教学主管,业务销售代表,区域经理,销售推广,网站运营专员,销售顾问
客户服务管理	客服，房地产，人力资源，销售，顾问，银行，
软件销售	销售经理
javaweb开发	初级软件工程师
系统	ERP运维
熟练操作office办公软件	财务会计
QA & TEST-C++test	架构师，项目经理，技术经理，高级顾问,FAE ,销售工程师,总经理,测试工程师
常用办公软件、ERP软件	财务总监助理&财务分析
pro/e三维建模	销售经理
X Windows Servers	网络工程师
Word, Excel, PowerPoint, Outlook	采购/贸易，机械工程师
MySQL等	作家
熟练掌握基于struts+spring+	java工程师
ERP-用友	财务部长
开发工具：VC6.0 、Visual S	软件测试工程师
压力容器	操作技术
工程管理	工程师,土建工程师,工程管理,技术员工程监理项目主管,工程造价,工程项目经理,Senior manufacturing engineer,职员,项目总经理或项目副总经理
会计电算化证书	会计助理,会计,餐厅经理 店长 大堂经理 ,中国区总裁和德国董事的秘书、翻译，兼任出纳,人力资源类,会计主管,深圳富士康集团,财务总监、财务经理、主管会计,出纳员/会计助理,会计助理、出纳
QuickTest Profession	软件测试经理 主管
spss	会计,理财类,财务管理，采购，物流,数据分析,数据分析员,债券交易员
struts1	java软件工程师
struts2	java软件工程师,java开发工程师,软件工程师,java 软件工程师,java开发,java软件开发
PCB布线	硬件工程师/PCB工程师,硬件工程师,应届毕业生,电子工程是助理,单片机软硬件，电子工程师
ospf	网络工程师
Office软件	化工设计,高级软件工程师
Kingview、office、CAD	电气工程师
outlook	经理助理,无
Shell脚本	软件工程师
机动车驾驶证C	项目经理,电气技术员,外语 市场 行政,征信调查,人事、行政、财务会计、助理,售后服务,财务,管理培训生,仓库/物料管理员,行政助理
机动车驾驶证B	人力资源主管,行政助理
服务器存储管理	小型机维护工程师
软件测试	软件测试工程师,软件测试,测试工程师,软件、测试、项目,网络工程师,技术支持,测试工程师及测试项目负责人,软件工程师,QA,linux嵌入式C开发工程师，嵌入式工程师,linux驱动工程师
Unix/Linux/BSD Develop-C++	软件工程师
Protel 99SE	电子工程师
视频制作	行政总监、经理,机电工程师,市场部经理
视频编辑/制作	产品经理
3dStudio Max	产品设计
CSS+DIV	软件工程师,java软件工程师,程序员,网站美工,java工程师,网页设计/美工,网页设计,网站维护/设计/推广,网页设计师,前端开发
电气工程	电气工程师,技术支持工程师
数学教学	数据分析，会计，教师，广播电台主持人
Fluent 软件	流体力学,结构设计
bloomberg等金融软件	资金交易
palisade decition	数据分析
TracePro	结构工程师
业务流程管理	业务拓展主管
caxa机械制图	技术 设计 科研
金蝶及用友软件	会计
offce办公软件	机械工程师
sql server 数据库	e-HR实施顾问,java程序员
WORD,EXCEL	设计
ajax/jquery	java初级软件工程师
3D、CAD制图软件	行政人事经理
硬件调试	电子工程师
3dMAX	UI设计师
Plant3D	工艺管道工程师
C/C++ linux	嵌入式软件工程师
设计模式	软件工程师,软件开发,高级软件工程师
AD9/AD10	单片机软件工程师
熟练运用excel，word，PowerPoint	船务
解决客户问题	销售代表
illustrator	平面设计师,平面设计,网页设计,交互设计师, 产品设计师实习,采购主管,服装设计助理
多线程	项目经理
SPSS、AMOS数据处理软件	The minister of executive department
分析技能	投资管理,研发工程师,工程师,董事
win XP	机械工程师
办公设备	行政助理、人事助理
Adobe illustrator	服装设计,设计总监
Oracle、SQL Server	高级软件开发工程师
ac	客户经理
Network-TCP\/IP	项目经理,技术支持工程师,软件工程师,网络工程师,软件测试工程师,IT 总监,项目工程师/项目经理,Tech Lead/Scrum Master/Team Leader/软件架构师/高级软件工程师,软件研发工程师,运维经理
ae	fl动画
ai	UXD
用友ERP和中远集团OA系统	副总裁
SYBASE IQ	数据库工程师/管理员
.NET	网站编辑,软件工程师,C#开发,IT审计,总经理助理
Database-Visual Foxpro	财务,会计,技术支持工程师,办公室主任,HR,行政人事专员,经理助理、人事主管,测试部,财务会计,财务经理
photoshop、chemoffice	制造工程师
ibatis	软件工程师
Microsoft Windows操作系统	技术支持工程师/项目管理师/销售工程师,测试工程师,企业研发，设计院，大学教师，博士后,市场专员,软件测试工程师,律师助理,客户代表,商务经理,人力资源,Linux系统工程师
IPPBX	测试部部门经理
Web Develop-ASP.NET(VB.NET)	研究分析师,渠道管理,欧美事业部 副总经理/副总裁,sharepoint软件工程师
数据结构和算法	C++软件工程师,软件实施顾问
工程制图	质检员
熟悉QT开发工具	嵌入式开发
VISO	总经理助理
C/Assembly Language	高级硬件工程师
Dell PowerEdge Servers	系统工程师
coreldraw	开发/设计部助理,设计师,会计,平面设计师,生产人员
印刷	美术编辑
网站推广	网络管理员
Powerpoit	外贸业务员
熟悉Android下的网络通信机制TCP	android手机软件开发
工艺设计	工艺设计师,技术支持工程师
EXCEL	数据分析,会计,技术员,英语教师,财务,企划储备干部,人事助理,市场,仓库帐务管理,工程师
合同起草	预算员,技术支持工程师
Eclipse IDE	Java工程师,软件工程师,android工程师
物料需求计划(MRP)	应届生 ERP  SAP
XMind	主编
国际贸易	经理,销售经理，助理
linux系统编程	嵌入式软件工程师,软件工程师
InDesign	平面设计师,主管
cool edit	企业文化专员/主管
Suse,Redhat,Mac操作系统	软件测试工程师
Adobe Dreamweaver	审计助理
visualfoxpro	室内设计助理
鼎信诺审计系统	财务/会计助理
Internet应用	钻井工程师
Resin	Java工程师
技术领导	技术部研发
html/javascript	软件工程师
原画设计	分镜师
JAVA	软件工程师,java软件工程师,java程序员,程序员,产品经理,项目经理,软件测试工程师,android开发工程师,软件开发工程师,嵌入式软件工程师
webservice	java研发,java程序员
.Net编程	网站主管
电子绘图软件	高级电子工程师（研发经理）
工程仿真软件matlab	电气工程师
PS制图	建筑设计
CADD （计算机辅助设计和制图）ps 天正	实习生
西餐烹饪	口译，笔译
office日常办公软件	造价员
HTML ,DIV+CSS 	java软件工程师
Windows Office	会计
Microsoft visio	硬件工程师
Sockets	Android软件开发工程师,软件工程师,开发工程师
HTML/PHP	软件工程师
cocos2dx	程序员
html,css,javascript	java软件工程师
Web Develop-XML	软件工程师,高级软件工程师,项目经理,首席架构师,开发人员,高级项目经理,产品总监,需求分析师,软件项目工程师、产品工程师,JAVA软件开发
协议开发、制定，评审	技术总监
Bladed	仿真工程师
原型	售前顾问
J2EE软件系统开发	java软件工程师
PLC编程	机械工程师
文字编辑	日文相关,文案，片花预告，后期剪辑,法务人员
Redmine项目管理工具	产品助理
Flothermal	产品经理
Adobe InDesign	平面设计师,美术编辑,美编设计 设计主管,记者 ,编辑、运营,医药分析研究；CRA临床监察员,平面/插画设计师,全职，媒体，媒介
 2、检查标准、作业规范制作、量具检定等	质量工程师
ITIL(IT基础设施库)	IT经理,网络工程师
j2ee/servlet,jsp	java相关工作
计算机网络技术	硬件工程师,通信工程师,作业员
用户界面(UI)需求	产品经理/设计主管
生产计划	高级经理
SAP R/3	供应链经理/主管
hibernate、mybatis	java程序员
图片处理	财务管理
Hardware-Digital Product	工程部经理,软件工程师,行业研究 投资分析 生物医药 新材料 新能源,液晶模块开发设计师,FPGA工程师,销售项目经理,高级硬件工程师,研发工程师,高级硬件、FPGA开发工程师
咨询	集团常务副总裁,测试工程师
painter	原画师
C语言 单片机 	嵌入式系统、硬件工程师、软件工程师、集成电路设计
UG/PROE	内外饰（助理）工程师
广联达算量及计价软件	造价工程师
熟练使用office办公软件	人事专员/人事主管,软件测试工程师、技术支持、电子/电气工程师、单片机开发,品控，培训生,咨询顾问,测试员、技术服务、技术支持,机械相关
施工预算	施工员，测量，资料员
营销 管理 	销售
Java软件开发。	网站运维
c/c++编程	软件工程师
Visual Foxpro	英语翻译,客户服务类,市场经理
modelsim软件	硬件开发/FPGA开发
ps图形图像处理	网络营销 网络客服 办公室科员
韩语	教师 单证员,销售,贸易 进出口,外贸助理,财务部实习生
word、office	行政文员
UCD理论	运营
Indesign	英语翻译,活动策划,视觉设计师,平面设计,交互设计师,平面设计实习生
ETL框架设计	产品经理
物料审核	采购经理
vfp二级	人事助理
.Net Remoting	C#软件工程师
MASTERCAM X2	技术研发工程师
Hyperion Essbase	财务总监 
俄语	销售代表,俄语类,业务主管兼俄语翻译,俄语翻译，法语翻译，管理培训生,俄语外贸、俄语翻译,销售代表(网络推广),俄语翻译
Microsoft Office Exc	土建工程师
财务会计	主管会计
SQLsever	管培生
Flex技术	软件工程师
排球	职员
V C 6.0	硬件工程师
熟练掌握Photoshop 等图片处理软件；	编辑
生产管理	生产主管,服装QC  服装生产跟单  QA   QC主管   生产管理,生产总监,高级主管／经理,生产线组长,主管,生产管理,厂长,Project transfer  &   PD manager,生产副总、常务副总、总经理
电信运营支撑工程师	销售工程师
IAR编译器	嵌入式工程师
电气控制系统	测试工程师、电气工程师,电气技术员,工程师
HTML及客户端脚本编写	咨询顾问
pro/e&UG	物流专员/助理、机械类
高分子材料	技术员
FLUENT	CAE
熟练运用excel、word、ppt等办公软件	区域销售经理、新产品推广经理、区域销售管理
google sketchup	景观设计类
oracle+sql server	java程序员
数据结构	linux服务端软件工程师,项目经理/主办,软件开发工程师,软件工程师,C/C++软件工程师,java软件工程师,linux软件工程师
Microsoft Word	实习生,会计助理,市场策划 市场助理 活动策划,工业工程师,工程师,销售副总,HR,热能 ,软件工程师,策划
candence	高级硬件工程师
Aotu CAD	网络维护工程师
多进程/多线程开发	C/C++研发工程师
测试	测试工程师,软件工程师,QA，测试工程师，软件工程师
汇编语言和C++	软件研发工程师
PHP Scripting Language (PHP Hypertext Preprocessor)	php程序员,工程师助理,软件开发工程师,PHP项目经理,PHP开发工程师,软件测试工程师,php开发或者web前端开发,数据库维护开发工程师,PHP
NFC	嵌入式软件工程师
MIS商业系统	采购主管
３Ｄｓ　ｍａｘ	unity3D工程师
MyEclipse	java软件工程师,Java 工程师,C++工程师,软件工程师
测试文档编写	软件测试工程师
土木工程	土建工程师
数据库（SQLite）	Android开发
SQL、SQL Server	软件测试
Coredraw位图处理	暖通工程师
SPSS软件	用户研究员
Project Management	投资管理/证券分析/财务分析/信贷分析
IBM DB2 UDB (Database 2 Universal Database)	软件开发工程师
SqlServer、c#	网站、网页设计维护师
熟练掌握BUG管理工具QC，并熟练使用企	实施工程师
Matlab/Simulink	算法工程师
GDB调试的基本用法	C++软件开发
cad proe	机械工程师，结构工程师，模具工程师
IT-故障管理	IT专员
工艺流程	高级副总裁
Adobe Premiere Pro	元件动画制作
R语言	研究员,环境影响评价编制
Coleldraw	产品设计
熟练掌握jira测试管理工具以及svn、	软件测试工程师
windows系统	网站编辑,linux运维工程师
广联达工程造价系列软件	土木工程师
学生服务	策划
ANSYS有限元结构分析	设计技术员
Office Applications-Wordperfect	市场部经理,分析师,行政人事经理,江西区域推广经理,助理总监,总经理助理,结构工程师
产品生命周期管理	产品总监,深圳宝安分公司负责人
PHP/JSP	量化策略研发岗位
嵌入式编程语言	控制器部主任
翻译软件trados，Google	西班牙语翻译
数据管理	数据库营销,区域销售经理
市场分析	网站编辑
Unspecified	软件工程师,审计师,软件开发工程师,心理咨询师助理 经理助理 行政 客户主管,计划与流程主管,行政文员,iOS软件工程师,Product manager,企业客服专员,销售经理
Altium Designer	硬件工程师,计量工程师,研发工程师,硬件工程师 电气工程师 嵌入式,北京阿奇夏米尔工业电子有限公司
H3CNE	网络管理员
合同管理	商务助理 / 销售支持,技术管理,文秘、新闻、事务管理、采购
word、excel、PPT	项目经理
Oracle HFM	合并报表
DXP/Protel99SE 软件应用	硬件工程师
office办公软件	施工员,Java工程师,助理工程师,市场专员,软件工程师,无,NVH试验/仿真工程师,工程造价,西班牙语翻译,造价员
工具类、通用控件编写	ios开发工程师 ios研发工程师 
SIP (会话初始协议)	研发工程师
solidworks2010-2013	机械设计工程师
Windows Develop-CORBA	Team manager, Specialist,Team Manager, Software Specialist
数控机床	销售员、仓管、出纳、木材加工管理员,装配钳工,数控车工
七、有数字电子理论基础、简单数字电路与音视频应用	Layout工程师
Intouch	电气工程师
Design/Media-Protel	设计验证工程师,技术员,electronical engineer,机电工程师,生产部经理,产品总监,电气工程师,FAE,电子工程师,嵌入式工程师
驾驶（C1）	技术员（自动化反面）、储备干部
objectivec	软件工程师
Web Develop-Visual studio	电子商务运营主管/经理,电气工程师,测试主管
体育教育	销售、客服、教师
LR、QTP、TD、winnerrunn	软件测试工程师
软件开发流程	iOS开发工程师
播音/主持	编辑、记者、企划,店员,会计、会计助理、税务会计、成本会计,行政
oracle、mysql等	java开发工程师
Labview	测试工程师,电子工程师、电气工程师、plc工程师、硬件工程师、仪器仪表、自动控制
产品包装	网站运营，网站策划
数控编程	网站策划、网页设计/制作/美工、网站编辑、电子商务专员、网站营运专员,技术员,制图员,数控镗铣工,产品工艺工程师,数控车工
掌握JavaScript脚本设计	java软件工程师
常用办公软件word，excel等	文档工程师
C#.net	软件工程师
patran/nastran	CAE工程师
摄影	摄影师,摄影师/摄像师，原画师，编辑，排版设计，总编/副总编 ,执行主编,市场部主管,财务,项目经理助理,销售/经纪人、市场专员/市场助理、产品/品牌专员/助理、公关专员/助理、媒介策划/管理,插画师，剪辑师，幼儿美术教师,媒体从业人员,ui设计师
服装配色	设计师
Cimatron E9.0	室内设计
js+Jquery+ajax	C#程序员
SU	景观设计,建筑公司,绿化设计师
ASP.NET	软件工程师,软件开发,初级软件测试工程师
HP Service Manager 	项目经理
熟悉VLAN、ACL、STP、HSRP、	网络管理员
3D建模	施工员,市场推广,建型师,市场调研、策划,行政助理,系统管理员,设计主管,设计师助理
Java编程	java软件工程师,QE质量工程师
office、cad	工业工程师
培训视频剪接、编辑	培训总监
Pro-E三维建模、结构设计	产品工程师
Word编辑，Excel函数等	人力资源管理
MS EXCEL	俄语翻译
inventor	Senior Sourcing Specialist
cognos,datastage	报表开发工程师
linux系统程序设计（LSD）	嵌入式软件开发
无盘工作站建设	公司网管
二级Access	会计
AutoCAD 制图	结构开发
逻辑语言	策划、咨询、编辑
PRO/E、AutoCAD、AI等	采购工程师
synplify	FPGA工程师
JDBC (Java Database Connectivity)	java软件工程师
熟练掌握HTML ，JavaScript	java工程师
apache tomcat	java
IBM AIX操作系统	系统管理员,项目经理,Project Manager
css+div	web前端开发工程师
UG4.0	机械设计工程师
CAD	销售代表,售前技术支持工程师,印刷相关,厂务设施经理 ,储备干部,采购部经理,建筑设计,造价,测量员,空间设计
熟悉c语言	linux-c开发工程师，软件工程师,办事处技术人员
FFmpeg	软件开发工程师
精通JSTL标签及struts2标签	java软件开发及其相关职业
室内设计	室内设计师,设计师,室内设计师助理,设计经理,设计总监，首席设计，高级设计,室内设计总监,审判员,室内外装潢设计,室内设计师，深化设计师
Cocos2d基础	C++工程师
FPGA/VHDL/LIBERO	单片机软件、硬件
Network-LAN	IT,售前 技术支持 售后经理,售前技术支持工程师,通信工程师,LED照明事业部供应链管理部:     采购经理,软件工程师,无,总工,Product manager,硬件研发工程师
Java Swing	高级软件工程师
juniper（交换机、防火墙）	网络工程师
c++开发	C++程序员,项目经理
Java 2 Platform Standard Edition (J2SE)	软件工程师,初级程序员
windows mobile 开发	oracle  DBA
windows下的MFC编程	linux C/C++开发
Shell脚本编程	软件工程师
自动化测试工具	软件测试
C++标准模板库(STL)	高级软件工程师
MS Office Excel	电气助理工程师
WCF	C#软件工程师,项目经理
oracle   mysql	java
Adobe Flash	网页设计师
PROE	机械工程师,机电工程师,产品工程师,设备工程师,品质管理,机械设计工程师,助理工艺工程师,总装工艺工程师
MS Powerpoint	总经理,教育培训,英语教师，英文翻译
word，ppt，excel	网络
Emacs文本编辑器	研究员
Eduis、PS基础操作	电视编导
HTML (超文本标记语言)	软件工程师,电子商务,产品经理,高级工程师,法务专员,web前端开发 Javascript开发工程师,售前售后技术支持/java软件工程师,软件测试工程师,项目管理,ios 软件工程师
cet-4	法务专员 律师助理
影视制作	动画
梦龙项目管理软件	工程部主任
计算机安全	网络工程师 
Eviews	Researcher,数据分析（数据挖掘）,外贸专员,管理培训生,投资
管理策略	助理类 生产管理,品质管理/生产管理,销售总监,经理,机构品质工程师,顾问，经理助理，市场营销分析，战略分析
Linux	软件工程师,java程序员,软件测试工程师,Database Administrator,C++实习生,软件开发,EDA（FPGA、CPLD、PCB)设计,游戏服务器开发工程师,软件实施工程师,售前技术支持
MCSE	项目实施工程师
PROTEL,AUTOCAD	软件工程师
TCP/IP,HTTP	安全工程师
TS 16949	生产主管,体系工程师,生产调度、车间主管
photoshop	实习生,行政主管,室内设计师助理,策划、会展、顾问,外贸业务员,版权管理部门主管,网页制作/网站编辑,产品总监,电气工程师,Unity3D游戏开发
J2EE	软件工程师,浙江奥飞软件公司,项目经理,Android软件工程师,高级软件工程师,软件开发工程师,部门经理,java开发工程师,IT总监,架构师
会计电算化	财务经理
ps、cad、su	景观设计师
xmpp	android
销售管理	销售总监,销售管理,经理助理,集团销售总监,销售代表,OTC主管,客服专员,区域经理,区域经理、销售总监,区域销售、销售经理\主管、督导、营销经理、主管
.NET Compact Framework	副总裁
施工进度	施工员
Html	PHP,高级软件工程师
java开发	java开发工程师,求职,java初级工程师,java软件工程师,oracle维护与开发
熟练使用OFFICE	办公室主任
天线设计	天线工程师/射频工程师
sql数据库	实习生
Microsoft Office（Word、Excel、PowerPoint）	环保设计 环境相关
CAD、Solidworks	采购总监
Office excel	视频审核
Excel,Word和CAD的应用	生产主管
工程预算	采购工程师,会计文员,实习生、助理
linux环境编程	嵌入式linux软件工程师
SSHI	java软件开发工程师
英语作为第二语言(ESL/TESL)	区域销售经理,产品经理,管理培训生，柜员，客户经理，审计，财务,软件测试工程师,商务 项目助理,英文相关类,Eglish Interpreter or Translator；Manager Assistant; Manager or other management positions,副总经理,市场总监,俄语翻译
Struts 1.x	ERP软件工程师
人力资源	行政专员
Network-Cisco Routers	销售经理,技术支持工程师,IT Supervisor,网络通讯工程师,软件实施工程师,BI工程师,设计师,工程技术员,软件测试工程师,店务营业员
培训项目开发	品牌推广主管兼现场经理,培训师
3.\t熟悉Eclipse开发软件的使用。	android软件开发工程师
Silverlight	高级软件工程师
Illustrator	工业设计,设计师,网页、UI设计师,数字化品牌营销策划,企业文化专员,网页制作,平面设计,广告文案
IBM OS-390 Operating System	需求分析，系统分析，咨询顾问
管理咨询	咨询顾问、培训师、管理顾问、证券分析师,高级顾问/人力资源/战略管理,咨询总监
javascript(jquery)	程序员
技术培训	项目管理 机械设计
mvc设计模式开发	java开发工程师
环境微生物学	工程师,水处理员
生产系统	策划
C语言编程	造价员,服务工程师
Oracle和SQL	程序员
熟练AUTOCAD制图软件	水暖设计/采暖系统设计/现场管理/现场协调
风险管理	风险管理策略,客服经理,融资、资产管理、风险控制、金融创新
Network-IIS	开发工程师,首席运营官（监管行政人事总监）,网管,软件工程师,软件开发/技术研究,CIO,测试开发工程师经理,技术部经理,IT 副理,首席运营官COO、总裁 副总裁 总经理 副总经理 总监 事业部总经理
员工培训	保险主管,人事专员、招聘、培训专员、员工关系管理
adobe audition	FLASH 动画师
审机妙算	销售实习生
cad二级	现成技术
Hardware & Software	网络管理员
UGS NX	机械设计工程师
javascript，css	java
贸易	科伦包装材料有限公司
Sage 50	管理培训生
擅长VC++、VB程序设计	电子工程师
S2SH框架	java 开发工程师
Visual C#	项目管理
Java、c++、 c、OC	iOS开发工程师
Hibernate、Spring、Str	软件工程师
word,excel等办公软件	财务
Cadence	工程师,嵌入式工程师
熟练使用EXCEL、WORD、PPT等办公软件	培训主管
Hibernate	软件工程师,软件开发工程师,java软件工程师,java程序员,java软件开发工程师,java,Java工程师,中级Java工程师，高级java工程师，软件工程师,java 实习,JAVA实习生,软件需求分析
Bulk Emailers	销售助理，外贸跟单，外贸业务，咨询顾问
服装行业	QA/QC
网页制作与管理	通信 电子 销售 财会
erp系统软件	税务专员
软件编程和调试	IT工程师
单片机（80c51）	嵌入式C/C++开发工程师
硬件电路 	电气工程师
高效液相色谱法（HPLC）	研发工程师,品管员,实验员
Ajax，Servlet，JSP	Java相关技术岗位
asp	java工程师
.熟练Ajax技术.熟悉JQuery框架	Java软件工程师
网站管理	网络推广,网站编辑、建设、优化、推广/软件测试、研发,负责包装车间管理,产品经理 网站运营 项目经理
审计管理	财务管理会计
熟悉Nginx反向代理负载均衡；	软件工程师
文件系统	内核,总经理秘书
SKETCHUP	设计助理,方案景观设计
c、c++语言	软件工程师
Direct3D	软件设计师
Microsoft VBScript (Visual Basic Script) 脚本语言	软件开发工程师
bash	高级项目经理
JNCIP (Juniper Networks Certified Internet Professional)	CCIE Cisco 项目经理 技术经理 架构 管理 主管 Solutions Engineer network supprot IT manager    
mindmanger	运营经理
ms	管理培训生
Solid Works	技术支持经理,机械设计,丝印、移印、喷涂工程师
Linux 网络管理	网络管理员
photoshop图片处理	办公室助理/行政助理,土建施工
食品安全	质量管理
C，C#语言	技术负责人
网络销售	设计师,旅游与酒店管理 行政后勤文秘,电子商务/网络销售/业务员,网站运营 市场总监 市场策划
PC硬件	软件工程师
质量统计分析软件	供应链经理
编导	副总经理,后期制作,培训师
学术指导	实习生
DOS-based Microsoft Windows操作系统系列	技术支持工程师,精装
AJAX、DWR、JQuery	java开发工程师
数字电路设计	生产副总经理
OFFICE办公软件（Word,Excel,PPT）	家教
PRO/E  CAD	机械工程师
熟练掌握基于Struts，Hiberna	JAVA软件开发
Adobe产品系列	培训生、储备生、工程师等
Jdbc	java软件工程师
PL-SQL开发工具	.net软件工程师
After Effects	实习生,普工
熟练掌握基于Struts2,Hibern	java
Excel/PPT/Word	市场销售拓展经理
广东省一级计算机	会计
根据不同项目确立适当的测试策略	软件测试工程师
QTP	软件测试工程师,软件测试,软件工程师
MATLAB编程语言	软件工程师
ERP部分模块	会计
WPS	工程师
Microsoft Outlook	商务助理,ISO专员,设计师,国际销售,人事专员，总经理助理，行政
servlet、jsp	web前端
weblogic	JAVA软件开发及相关工作。
office系列办公软件	NPI工程师
结构工程	结构专业负责人
WPF	高级软件工程师
综合布线	网络工程师,弱电工程师
AFT Fathom	助理
渠道开发	销售工程师
机械制图	光学仪器助工,工程师助理  机械学徒 ,机械设计与制图,工业工程师或制造工程师,设备科科员,设备维护,设计工程师,产品主管
网络技术	销售支撑
学习能力	销售部经理
*多年建筑设计、建筑工程、土木工程方面的实际经验。  *擅长与建筑师、业主、小业主及下游厂商之间的	房地产开发 现场施工 结构设计师 ,项目总经理
Solidworks	机械工程师,研发工程师,自动化设备设计工程师,电气工程师,采购经理/主管,无,设备工程师,机械设计工程师,海外项目销售 管理,光学工程师
DIV+CSS布局	java程序员
Spss	曾在外资集团公司历任 CEO管理助理 、商务代表、亚州区商务经理，企业管控、分公司代总经理
cad 	设计
ERP系统-SAP	首席信息官CIO
SAP FI	技术顾问/实施顾问
AJAX (Asynchronous JavaScript and XML)	软件工程师,java软件工程师,高级软件工程师,Java工程师,项目经理,java,.net c# 软件开发,web前端开发或java实习生,无,C++软件工程师
PS、AI等	平面设计
ERP-SAP系统	审计助理
算法	策划，市场，销售，软件开发,Linux 软件工程师
Microsoft Transact-SQL (T-SQL)	测试工程师
jquery	前端工程师,.net软件开发,JAVA开发,网站美工设计与制作,web前端开发工程师,初级软件工程是,asp.net中级程序员
管家婆财贸双全软件	人事
UI基本框架运用以及第三方框架的使用	iOS软件开发工程师
Office PowerPoint	电泳技师、人事助理、培训专员、体系稽查、6S稽查、安全稽查、文控管理、文员等
培训师管理	管理培训,工艺工程师
心理测试	人力资源专员
湘原控规 鸿业市政	建筑设计师
二级C语言	电子工程师
Legal research	法律/公关/业务发展/高级行政
Java、C#、ORACLE	数据分析工程师
证券从业资格	财务实习生,经理助理,会计助理,银行 贸易 证券 金融 咨询,销售员,经理,银行职员,金融，财务类,专业人员,项目经理、产品经理
DreamWeaver	Web Product Manager
ERP (企业资源计划)	机械工程师,计划/调度主管,采购员,财务经理,优衣库副店长,煤炭业务员,网络管理员,仓库经理,市场营销策划,电子商务经理
MySql、oracle	软件工程师
SolidWorks 2014 x64	机械设计工程师 
计算机维修技能	电脑维修技术员
维修 	钳工
索尼维加斯（视频制作）	全职
计算机二级C	机电工程师
建筑设计	实习生,建筑师,室内设计师助理
5S现场管理	生产文员、助理，培训专员
流媒体	软件工程师
C++ Java	Android应用软件工程师
Java XML类库	java软件工程师
Android四大组件	Android程序员
熟练使用使用QC和bugzilla、JI	软件测试职位
Oracle， Linux， Flash	java工程师
Memcached	高级软件工程师/架构师,技术类管理、资深.NET开发
Web Develop-JSP	软件工程师,java程序员,项目经理,java软件工程师,程序员,软件开发工程师,Java工程师,mainframe软件工程师,初级软件工程师,IT经理,咨询顾问
PSPICE	电子设计工程师
Office Applications	工程师,桌面支持
Eplan	电气工程师 机电工程师  设备工程师
dSPACE	电力电子
单片机设计	电子工程师
国家计算机三级	环保工艺工程师
全国计算机等级考试c语言	电子工程师
CDR、Flash	平面设计
Microsoft Office	销售经理,产品经理,实习生,金融类,人事专员,行政经理,会计助理,市场/营销/拓展经理；促销经理；广告客户经理；系统管理员/网络管理员；网站营运经理/主管,铸造工程师,工程师
问题解决技能	行政助理
计算机三级数据库	淘宝售前客服
生产制造数据管理	生产主管
Pro-E	项目主管,销售代表,Project Engineer,sr engineer
FLAC3D	轨道交通
jsp	java开发工程师,java工程师,java,高级软件工程师,android技术开发,java软件工程师,java程序员
Axure RP Pro	UI设计师
英语专业八级；擅长笔译；表达地道； 	英语翻译
Autocad/3Dmax/VR/photoshop/powerpoint	室内设计师
新闻稿/软文	编辑、策划
广告制作	市场部助理
Tcp/Ip	嵌入式软件工程师
熟练使用ArcGIS	软件工程师、测试工程师
Pro-e	机械工程师
MVC开发，Smarty模板，Think	PHP程序员
计算机测试	施工员,软件测试,网络工程师 系统工程师 技术支持工程师
windows	制程工程师,实施工程师
Flash Develop	FLASH开发工程师
VISUAL C++	售前/售后工程师
mysql数据库	研发,android开发工程师
经济学	咨询顾问,软件测试
计算机组装维修	IT主管
熟Apache服务器了解Nginx服务器	php程序开发
Oracle、MySql数据库	java软件工程师
Driver's License	销售 业务 客户经理 外贸,行政专员/助理   金融/证券/投资,工程师
ERDAS	数据处理工程师
硬件设计和仿真软件	嵌入式系统工程师
行政管理技能	行政助理,经理助理,贸易专员,行政总监、行政经理,行政专员,行政管理,编辑,行政及其他管理岗位,秘书、助理,人力资源
Linux c/c++   	程序员、软件工程师
掌握C语言，AutoCAD软件	工业、工厂类电气工程师
工程造价	品管管理
JS	java开发工程师,java软件开发工程师
计算机应用技术	总经理
电子商务软件 (B2X)	销售总监
cdr	网页设计,淘宝美工
MySQL	java软件工程师,java工程师,java开发实习生,软件工程师,java程序员 软件工程师,安卓工程师,java开发工程师,seo,linux运维工程师,C#软件工程师
struts2、hibernate、sp	java开发
Mercury Interactive TestDirector	软件测试工程师
Matlab-GUI	汽车产品规划专员
风险分析	投资管理部业务主管
access	财务管理,审计助理,会计,编辑
HTML,CSS,DOM	软件工程师
Premiere	动画师,市场策划
计算机常见软硬件的安装调试	网络通信类工程师
Jsp、servlet	Java开发
系统维护	实施工程师，产品工程师
计算机office	科员
JAVASCRIPT、struts	java软件工程师
ps dw ai	电子商务运营
中间件-CICS	性能测试项目经理
失效分析	机械工程师,可靠性工程师
VM exsi	IT运维
abode acrobat	工程师
签证申请	施工员
RHCE认证	ORACLE数据库工程师
Linux系统	管理、行政、文秘、人力资源、翻译等相关专业
ARM汇编语言	嵌入式开发工程师
caxa	机械设计工程师,机械设计师
掌握Sqlite数据库以及Pull解析; 	Android软件开发工程师
熟练操作MS Office软件	实习生
财务报告	财务分析、内审经理
宏业计价清单	造价
安防系统	技术支持工程师 安防工程师 项目管理
计算机考试国家二级	经纪人
T-SQL	java程序员
模具调试	工装设计员
PLC使用	电气工程师
AutoCAD	机械工程师,工艺工程师,机械设计工程师,土建工程师,电子工程师,设计工程师,研发工程师,水处理工程师,暖通工程师,实习生
机动车驾驶证	行政专员/助理
软件设计	嵌入式软件项目主管，高级工程师,IT管理员
Microsoft COM (Component Object Model)	软件工程师
CAMplus数控机床编程软件	机电工程师
概预算软件	通信设计师
项目评估	销售经理
abap编程、ALV报表开发	实施顾问
房地产估价	资产估价，房地产估价，土地估价或专业相关
PHP	软件工程师,自动化测试工程师,电子商务运营专员,网页设计,系统开发,代码编写,PHP软件工程师
Tecplot	CFD工程师
JIRA	软件测试工程师-项目leader,软件测试
物流流程	人事 行政
H3C交换机配置	数据库系统工程师
自学sketchup	景观设计师实习
java/servlet/jdbc	Java工程师
熟悉HTML	java软件工程师
java，oracle，linux	oracle 数据库管理员
云计算	管理职位
Arena，Fixsim 仿真软件	持续改善主管
土地测量	资产评估
CAD中级证	电工,结构工程师
seo	网络推广经理
jsp、asp.net、css、xml	计算机软件
Xcode 开发工具	iOS 软件开发工程师
ERP-Oracle	行政人事副总经理,项目经理,海关事务部门经理,物流经理,测试经理,ERP应用咨询顾问,Accountant,CEO,President,总裁,IT,总裁助理兼市场部经理
javascript与Jquery框架	php程序员
php	web前端工程师,c++服务器开发,开发工程师 安全测试工程师,软件工程师,研发经理/主管,电子商务项目经理,flash程序员,软件测试工程师,android软件开发工程师,javaEE软件工程师
机电维修	电工
系统设计	项目管理,
CADCAM	制造部经理
MFC	c/c++软件工程师,C++程序员,C++程序员/软件开发工程师,软件开发工程师,C++软件开发
Linux操作系统	IOS应用开发工程师
PROE三维制图软件	助理工程师
JSP，MVC/Struts，Servl	高级软件工程师
DataStage	项目经理,商业智能/Cognos软件工程师
品茗安全软件	土建工程师
android应用开发	软件开发
Proteus	建筑电气工程师,软件/硬件工程师,技术员
全国计算机三级	销售
Microsoft Visual C 编程语言	测试工程师
实现和维护	销售
新闻策划	销售主管、渠道总监、市场总监,媒体、互联网、金融
office excel	客服主管,土建施工员
会计标准和法规	会计,无,财务会计
Java/JSP	Software Test/Application Support
javascript	web前端工程师,java开发工程师,php程序员,前端开发工程师,java,软件开发,软件开发工程师,软件工程师,,.net开发工程师,软件测试工程师
Sql Server管理和维护	运维工程师
protel、protues、PLC	辅导员
eviews软件	统计员
Develop-.NET	软件开发
熟悉C语言程序设计	想去银行工作
VISIO	产品经理,项目经理,嵌入式软件开发,乐达冷风机厂,实施部经理/高级实施顾问,常务副总
SQL SERVER,ORACLE	软件实施项目经理
计算机二级	实习生,无,销售经理,技术员,教师,会计,翻译,经理助理,技术支持工程师,助教兼职
ABAQUS	研究院 项目经理 工程师,机械工程师,镀膜工程师,结构工程师
具有良好的编程习惯，使用SVN团队协作。	iOS开发工程师
j2ee	java开发工程师,软件工程师,java软件工程师
熟练使用Microsoft Office	软件测试工程师
掌握arm开发平台	嵌入式开发工程师
PTC Pro/ENGINEER、AutoCAD	设计工程师
MindManager	高级工程师,软件开发岗 （合同制）,产品经理,互联网产品经理,产品经理、产品策划、产品专员,售前支持
财务	会计部门会计助理,软件工程师,会计，财务，会计助理,财务经理、财务主管,行政
电路设计	射频 硬件工程师
Flash/Flex	flash交互工程师
单证	船务主管,Manager Assistant,单证员,客户执行
熟练使用三层架构，抽象工厂设计模式;	软件工程师
质量保证	质量管理工程师
SSH(三大框架)	开发工程师
pdf	CAD技术
Moldflow/Minitab	项目经理
PRO/E	机械工程师,营业员,助理机电工程师,汽车底盘设计工程师,表面处理主管,机械加工工艺工程师,机械设计工程师,结构设计员,机械设计,设计主管
JQuery，EXT等主流JS框	java程序员
JavaWeb	软件开发工程师
c++，	淘宝客服
html、xml	java软件开发
Photo Shop	技术服务
计算机基础	会计
Unix/Linux/BSD Devel-Embedded	android 驱动工程师,软件工程师,研发工程师,RFID 电子工程师
solidwork	机械产品设计研发/开发/项目管理
Spring/Struts2	软件工程师
体育新闻编辑/写作	财务，人力资源,编辑，文案
linux	软件工程师,软件测试工程师,C++开发工程师,软件开发工程师,数据库工程师,测试工程师/web/项目质量保证,无,android开发工程师,客服,初级程序员
ARM开发	嵌入式开发工程师
TSSD	结构工程师
AutoCAD(中级)	计算机，售后，客服，市场，猎头
Adobe Illustrator	平面设计师,管理培训生,服装类,平面设计,机械设计工程师,平面设计美工,设计师助理,咨询师,设计助理,高级ued经理
pr	记者
ps	景观设计助理,工程师助理,行政前台,室内设计师助理,景观园林设计师助理,设计,景观设计师助理,平面设计,游戏原画,经理助理
java	软件测试工程师,软件工程师,工程师,java web开发工程师,图像处理,C++软件工程师,ios软件工程师,嵌入式linux软件工程师,java开发工程师,c++开发工程师
Bash (Bourne Again Shell)脚本	售前工程师,C++研发/软件架构师
市场调研	经理助理,商务专员，贸易专员,网络管理,项目经理/总监,咨询师 / 策划专员,人事专员/人事助理,销售主管
Adobe Pagemaker	品牌经理  公关经理
驾照c证	报关 跟单
专业教育软件	通信
Corel WordPerfect Office	摄影师
MATLAB	机械工程师,工程师,软件工程师,证券/投资/基金/财务/理财/市场策划,电气设计,助理工程师,专利代理人,机械设计工程师,嵌入式软件工程师 单片机 dsp,助理研究员
AUTOCAD制图软件	装配工程师
草图大师	景观设计师,助理设计师
计算机辅助工程 (CAE)	办公室文员,机械工程师 机械设计师,机械设计,工程师,渠道销售
Protel 99 SE	软件测试工程师
XML	软件开发工程师,ASP.NETt程序员,java软件工程师
CorelDRAW	软装设计师,服装设计师助理,室内设计师助理,高级展览设计师,办公室办事员,工业设计师,设计总监
Cam350	PM
Windows Develop-Visual studio	北京奥维奥科技有限公司,系统项目管理工程师
Jsp+Servlet+JavaBean	软件工程师
Linux交叉编译工具	嵌入式软件工程师
WebDesign	WLAN无线工程师
国际营销	技术支持、国际贸易、市场营销
设计类 AutoCAD	电极材料研发
全国计算机等级二级（C语言）	信息管理
AutoCAD、SketchUp、Photoshop	景观设计师
广联达算量计价软件	土建施工员
人工智能算法	算法工程师
INFOR LN ERP	ERP工程师
熟练应用Spring，熟悉MVC三层架构	java程序员
熟练掌握QTP等自动化测试工具，能熟练编	软件测试工程师
终端销售点促销	渠道执行经理
TIA PORTV12	工程师
会计认证	会计,通信管理/运营/增值类、IT支撑、行政及商务管理,仓库管理员,财务相关,人事专员,无,会计助理、会计文员、会计,财务主管,出纳员,会计；出纳员；财务/会计助理；会计文员
protel 99se	单片机工程师/助理工程师
SAP system	IT技术支持
corejava	java软件工程师
STAAD PRO	结构工程师
计算机三级偏软	软件测试工程师
jpa	java工程师
风险投资	董事会秘书
车间管理	车间主任
旅游业	市场主管 公关经理
ANSYS	机械工程师,CAE工程师,幕墙设计,研发工程师,愿意从事与机械设计制造及其自动化有关的研究、开发、生产及管理工作！,全职,机械设计师 机械工程师 结构工程师,机械设计、分析类职位,机械设计师,机械设计工程师
oracle ，sqlserver数据库	java软件工程师
C/C++ MATLAB 	软件工程师
MATLAB、SPSS统计软件	数据分析师
音频处理软件	财务助理 \ 实习生
注塑成型	美的零部件公司注塑厂长,成型技术员
JavaScript、Jquery	Java软件工程师
计算机三级（数据库）	数据分析师
软件编程	嵌入式软件工程师
AutoCAD、PRO/E、CATIA	机械工程师
计算机技术及应用	项目经理助理
Office软件使用	汽车/摩托车制造、工程机械、
.net (C#)	计算机软件工程师
金融excel	风控，投资，副总，助理。
POTSHOP,CDR	采购
预算软件	部门总监
SQL Server,mysql	软件工程师
版权	副总编
Linux系统下字符驱动设备的编写	嵌入式软件工程师
java 三大框架开发	java软件工程师
SQL Server数据库	财务分析
WAP (无线应用协议) Enabled PDAs	翻译
android移动软件开发	MMI软件开发工程师
坚持到底	福建大区+区域经理
GSM （全球移动通信系统）	网优工程师,无线网络优化工程师,GSM网络优化
视频剪辑	后期剪辑
投资分析	技术总监,中高级管理人员
GIT程序版本管理	linux 软件工程师
UMTS（通用移动通信系统）	项目管理/产品经理/销售经理
市场营销	市场总监 区域经理 市场经理 策划 市场营销 推广 品牌经理,大区经理,市场开发/销售/外贸,股权投资或销售类,店长、值班经理,高级咨询顾问,市场营销,广告 销售 主管 本科 3年以上 招商 业务 精英,传媒,医药代表
通信行业	通信设计
动画	动画
熟练操作电脑 	行政专员/助理
对Ajax, JQuery, 有一定的了	web前端工程师（实习）
OC语言	ios开发工程师
VHDL语言	论坛编辑
数据恢复	技术支持工程师
测试工具	测试工程师
金融/财务法规	财务总监CFO,财务主管，理财经理等,软件工程师,会计、总账会计、主管会计
JSP、Servlet、Java Bea	程序员
ADO.Net	软件研发
LINUX	DBA,通信工程师,产品经理,咨询顾问,软件测试工程师
html+javascript	技术主管
GDB (Gnu调试器)	资深软件工程师
c语言，c++	软件
Operating Systems-Windows NT/2000/XP	软件工程师,项目经理,产品经理,java程序员,教师,Senior Software Engineer,机械工程师,经理,行业研究员,总经理
Quicktest Professional	测试工程师,软件测试工程师
AUTO CAD	项目助理,水电设计员,销售助理,工艺,机械设计,矿物加工技术或设计岗位,焊接、热处理工程师,自动化控制工程师
通信集成电路	渠道客户经理
matlab、eviews	统计
Mysql	软件工程师,嵌入式linux驱动工程师,产品开发经理,Android开发工程师
单片机	嵌入式软件工程师,电子工程师,电气工程师,嵌入式工程师,软件工程师,通信/电子,机械工程师,单片机工程师/助理,嵌入式软件开发,电气设计工程师   电子设计工程师
Unix Linux	Unix工程师
Pyhton	程序员
羽毛球	行政经理，总裁秘书
Internet	项目管理
Struts+Spring+Hibern	软件工程师
Windows Develop-PowerBuilder	数据库管理员,开发工程师,软件高级工程师,项目经理（零售行业），项目总监（零售行业）,DBA,软件工程师,总经理秘书,中级软件开发工程师
Hardware-Computer	销售助理,Purchase manager,工程师,保税库项目经理,软件工程师,产品部,管理培训生,培训生,系统工程师 系统管理员 网络管理员 网络工程师 高级桌面工程师,运维经理
SPHR（高级人力资源管理专家）	人事主管；法务主管/专员；总监/部门经理；行政经理/主管/办公室主任
CAM350	Layout主管
Heperion	财务分析经理
广告设计	业务支持
MS OFFICE	设备经理,环保类,会计、人力资源暑期实习生,市场经理
计算机技能	管理培训生,审计助理,销售,总经理助理,行政，助理，秘书，,销售部经理/大区经理/办事处经理/分公司经理/区域经理/省级经理,DBA，数据库，oracle,外贸业务员,土建经理,新能源咨询/投资顾问
Windows XP	无
TCP/IP协议编程	高级软件工程师
护理认证	深圳市健桥妇科医院,医疗
PDM、capp	冲压工艺师
网络	软件程序员,技术支持工程师,产品经理,工程师,测试 培训
Photoshop、Illustrator、InDesign	平面设计师
销售工具	区域销售经理
应用中间件	程序员
office办公软件，Photoshop	研发
3D MAX	平面设计,施工员,室内设计师,动作设计
Aspen plus，HYSYS	工艺工程师
材料工程	焊接工程师、材料工程师
工业设计	工业设计及管理,工业设计/产品经理,工业设计,工业/产品设计师
Aix	数据库工程师
西班牙语	西班牙语翻译  西班牙语业务员,西班牙语,西班牙语翻译,编辑,西班牙语有关的职业,采购工程师
Microsoft word	陈列经理
mysql,Oracle,sqlserv	java软件工程师
各类Linux系统相关	BI相关
CAD  PROE	暖通工程师
天正建筑	施工员,建筑设计,设计师助理
MS Project	人力资源,Project manager
Div	Java软件工程师
销售终端（POS）系统	店长
自动办公软件	设计员
OF	学生会主席
CAD工程图	制图员
临床试验方案设计、数据管理、统计分析 	数据管理、统计分析、临床研究
硬件组件	计算机教师
OA	人力资源总监
数据库（sqlsever，mysql）	软件开发工程师
学校管理	驻外翻译
时钟设计	产品经理，客户经理，销售，市场
协调能力	秘书/助理/文员/教师,网路编辑,生产管理,助理
销售沟通	进出口贸易
VC＋＋编程	C/C++
EXECL	成本管理工程师
C,C++,JAVA	数据库开发工程师
C51	电器维修工程师
幕墙工程	幕墙技术总工程师
spring	项目经理,java程序员,java软件工程师,前端或后台,java开发工程师
电子商务 (B2X) 市场营销	电子商务,社区商务专员,市场经理,市场部经理
Visio	软件工程师,技术主任
Marketing Representa	Product manager
品牌策划	平面设计
熟练运用Struts2、Hibernat	Java程序员
销售终端(POS)安装	网络部部长
页面切图	网站制作/网站策划
Corel Draw	平面设计,服务器/系统管理/IT/技术/运维工程师,美术编辑
proE	机械工程师,机械设计师
财务软件（SAP\用友\金蝶）	预算及报表分析主管
软件架构设计	高级客户代表
商务演示（Powerpoint）	Analyst 分析员 管理培训
QC/TD8.0	软件测试工程师
AJax,ASP.Net,ADO.net	Unity3d游戏开发工程师
scala	Manager of Control Department
WINCC 组态软件	助理电气工程师
SIMATIC Manager	电气工程师
软硬件维修维护	设备经理
PCB绘制软件Protel、 AD	嵌入式软件工程师
英语教学	英文翻译，董事长/总经理助理,英语教师,管理,服务员,法务总监/法务经理,英文培训师， 银行客户经理,英语翻译、教师,英语，翻译，英语翻译,教师或翻译
成本-产量-利润分析	销售经理 销售总监
proe	助理工程师 绘图员,产品结构工程师,制图员,机构工程师(ME),机械设计,机构设计工程师,机械设计工程师,钣金制图员,机械工程师
proc	程序员
浙江省网络技术三级	外贸会计、往来会计
Unity3d	3D场景建模,游戏开发工程师
熟练掌握mysql5.0,oracle1	程序员
Oracle数据库	java软件工程师,软件开发工程师,Java工程师,技术支持工程师,软件测试工程师,java软件开发工程师,软件测试,java软件工程师,web前端,应用工程师,软件工程师
html/css	软件开发工程师
相关需求及设计文档编写能力；	高级软件工程师
Lucene	北京鹏润鸿途科技有限公司
熟悉VS2010开发环境	VC++
熟练使用SolidWorks	机械工程师
销售分析	市场主管、运营分析
Microsoft Office XP	客户经理,人事行政助理
java语言，j2EE开发，MVC分层架构	软件工程师
Linux下的程序设计	嵌入式Linux软件工程师
vc6.0	研发工程师
市场推广	副总经理，总监，经理,初级职位,营销管理培训生 人力资源管理,商务管理,Marketing Manager or Director,市场相关
办公软件power point	环保工程师
搜索引擎优化 (SEO)	销售代表,SEO优化营销推广,SEO 工程师,业务,运营总监,市场部,SEO主管,学生
Design/Media-PhotoShop	工程师,市场经理,结构工程师,SEO优化专员,营销推广经理,winorm, 农产品检测 土壤肥料 肥料推广 肥效试验 肥料研发 生产管理,软件工程师,理财顾问,培训主管
abaqus有限元分析	焊接工程师
Mercury Interactive LoadRunner	软件测试工程师,测试工程师
In Desing	平面设计师
SOILIDWORKS	电气工程师，机械工程师，设备工程师，设备管理
单片机嵌入式	软件测试工程师
LS-DYNA	CAE工程师，包装工程师
Webwork	JAVA开发
熟悉测试流程，能根据需求文档编写测试用例	软件测试工程师
ACE	C/C++软件工程师
SQL server	软件研发工程师,C/C++软件工程师,软件工程师,软件测试工程师
ehr系统	人事专员
金融分析	投资银行分析师,金融分析,金融研究员
篮球	Private First Class,计算机软件工程师
html、html5、css2	java工程师
Origin、ChemDraw等华工软件	高分子材料相关
丰田生产系统（TPS）	精益生产工程师
CAD/CATIA/UG/OFFICE	装配工艺工程师
导游	代课老师,行政人事助理、讲解员、编辑文案、文员,媒体关系经理,导游,HRM、行政、教学,会计、审计,市场部主管,人事专员 旅游顾问
信息安全	光网络覆盖
促销	机械工程师
por/E	机械工程师
FLASH BUILDER	AS3
Adobe Premiere	记者，编辑，网络编辑,助理，兼职,交互设计/视频编辑制作/UI设计,室内设计师,FLASH动画师,编辑/编导/记者/公关/教师,文案,机械工程师,运营经理;运营总监;产品经理,后期编辑
PHOTO SHOP	管理培训生
Adobe Audition	银行、事业单位、通讯行业职员或公务员,外贸
3ds max	平面设计师
产品自动化测试方案和原理	软件工程师
matlab软件	统计专员
Network-Advance Link	产品经理,仓库或物流主管,国际销售, 经理, 专员, 助理, 秘书, 翻译,副总经理兼任技术总监,智能工程部技术员,质量部总监（经理）
ASD09	研发工程师
电子商务系统	行政总监
FPGA电路设计	硬件工程师
PS、AI	公关助理,总经理
AUTOCAD	电气工程师,水处理工程师,设计,开闭件工程师,土建工程师,营业厅经理,机械工程师,室内设计助理,机械设计师,电子研发工程师
ERP SAP 熟练使用	财务部
财务预测	财务相关职位
KeyShop3	工业/产品设计
Excel	会计,律师助理,软件测试工程师,产品经理,项目工程管理,unity程序员,安全总监,外贸业务员,策划,船体设计师
PROE造型	工艺管理
精通主流开发框架如ssi,ssh	Java工程师
Windows Develop-C++	软件工程师,项目经理,高级软件工程师,技术总监,技术支持工程师,协议软件开发工程师,研发工程师,高级工程师,技术支持,工程师助理
MS Office Visio	银行对公客户经理
sketchup	景观设计师,绘图员、资料员、工程助理、质检员,园林景观设计
EMC存储系统	系统工程师
linux,fedora	嵌入式软件开发工程师
bodypaint	3D场景建模
NX8.0	工程师
熟悉C、Java语言，具有一定的编程能力	软件测工程师
mfc,matlab	技术开发部门软件工程师
Linux编程	软件工程师,嵌入式软件工程师,嵌入式linux研发/软件工程师,软件开发,Linux C/C++软件工程师,嵌入式软件研发工程师,ETL高级工程师,engineer
初级会计师	会计,财务经理,会计、会计助理、出纳、,稽核员,会计主管,会计、税务、审计,会计主管。总账，会计。成本。,初级会计师
groovy	程序员
招标投标	销售助理
axure rp	总经理/副总/COO/CMO
Office	电气工程师,IE工程师,摄影师,鞋类产品设计师,平面设计师,造价工程师,文 职,软件测试,编辑,关于销售方面的
Hardware-CAD	项目经理,电气工程师,工程师,生产厂长，经理，主管,产品工程师,辅导教师,电子硬件研发工程师,常务副总经理,设计师,投资分析师
Firewall	项目管理
财务管理	财务经理,财务主管/会计/成本主管/财务分析/等,主管会计或者高级审计师,营销总监,财务主管,财务部实习生,项目财务主管,财务经理、审计经理、财务总监,财务副总裁或财务总监,财务经理/采购经理
审计软件	审计员
熟练使用freecale单片机编程、使用三菱FX系列PLC编写梯形图；	机械工程师
Java Servlets	销售或售前,软件工程师,java开发工程师
labview	实习生
shell编程	c/c++
MES	跟单
E-plan	现场调试工程师
mysql、sqlserver	java程序员
ug	生产管理,售后调试,机械工程师,模具设计,技术员
css+div+jquery	软件工程师
善于与人沟通	风险控制专员
网络与电话调试安装	行政经理
有驾驶证	会计，主管会计
垂直/行业营销	销售部
培训/教学课程	售前工程师
svn，git，maven	java开发
CPLD	电子研发工程师
Project  、Acrobat	售前技术支持
安全生产	管理、总务主管,行政人事主任
Proe软件	机器人工程师
JAVA/Android/C++	软件工程师
Pro/e、SOLIDWORKS	工程经理
UG NX	机械设计工程师,项目工程师 采购工程师,助理工程师,模具设计,工程师,设计员,编程组长,机械设计,机械助理工程师,数控教师
jquery+ajax+json	java 软件工程师
营销手段	行政助理，营销专员,无,营销策划
人力资源管理软件	招聘/培训 人力资源 主管/经理 
供应链和采购	信息技术经理
项目管控，执行能力强	项目经理
PLC语言	机械工程师
网页前台编辑HTML	软件测试员
AD画图	行政人事助理
会计软件	财务助理,财务/会计主管；财务/会计经理；主办会计；会计,应收应付，财务助理，会计助理,，财务，会计,会计,财务会计,会计 会计助理,费用会计,会计，金融方面
金蝶&用友	财务经理
市场活动	媒介,销售主管
CSS2 (Cascading Style Sheet Version 2)	产品经理、前端开发
Word、Excel 	助理工程师
数据库应用	软件工程师
网站维护	网站策划/产品专员
现金制会计	英语翻译，助教，前台
C#、MFC	软件开发
c/c++	Department Manager (Software System Architect),网络排版员
AI	网页设计,室内设计师,资深品牌包装设计总监,平面设计师,设计,美术指导,翻译,美术编辑
培训/教学	高二物理实习教师,会计,市场支持、PR专员,音乐类、艺术类,培训讲师,研发人员,営業、生産管理、翻訳、店舗経営,心理咨询,营销拓展经理,翻译；英语客服；教师；
jquery1.7	软件工程师
Quality Center	测试工程师
Adobe After Effects	策划、编导、后期制作,设计师,Q版角色设计师,影视编辑 三维动画,3D动画建模
solidedge	机械工程师
AS	软件测试
各类社交软件、网站	AE
数据库编程	总经理
Protel 99se	软件工程师
ASP.NET(C#)	软件工程师
MATLAB等数学软件	刑侦相关工作
公关/媒体活动	媒介/公关经理,公关传播
svn	软件测试工程师
iscroll.js和zepto.js框	web前端开发工程师
flash(AS2.0/3.0)	IT信息化专员
Ai	活动策划,生产经理
Business Objects	ETL工程师
 平面设计	平面设计师
Network LAN	部门经理
Mac OSX 	运营总监
oracle	java开发工程师,java软件工程师,java工程师,技术支持工程师,软件开发,软件开发工程师,ERP实施顾问,成本分析主管,高级程序员,软件测试工程师
Aspen Plus	水处理工程师
计算机一级证书	市场推广
oracla	java软件开发工程师
microsoft office word 	财务
音响扩声	网络管理员
html + css	php程序员
sqlserver	软件工程师,java软件工程师,研发部研发工程师,软件开发工程师,软件实习生,技术支持,程序员
Objective-C编程语言	iPhone软件工程师,IOS游戏开发工程师,iPhone开发工程师,软件工程师,ios、iphone程序员,ios客户端研发实习生
3ds Max	设计师
办公软件，excel熟练	财会类
TCP/IP (传输控制协议/互联网协议)	product planning, 产品规划，售前，FAE，技术经理，现场工程师,软件工程师,软件测试工程师,软件开发工程师
金蝶、公易财务软件	财务主管、会计
熟练应用office办公软件	销售主管,客户经理助理
用友通财务软件	财务助理
Spring框架	对日 java 软件工程师,java程序员,java软件工程师,软件开发工程师,Java工程师
html+css+js+ajax	软件工程师
java .net	运维工程师
e-mail	行政助理
熟悉项目管理各种软件	部门经理
公关/媒体活动执行	客户/产品经理
C++二级	电源工程师
Unix操作系统	team leader,高级软件工程师
网络技术（路由器、交换机、防火墙等)	系统集成工程师
Microsoft  Office	县工程项目实施
LYNC安装管理	技术支持
财务分析	客户经理,邵珠华,研究员,管理,经理助理兼财务主管
Wincc组态画面	售后
Adobe认证产品专家 Dreamwea	销售助理
oracle,mysql	java开发实习生
质量管理	生产经理,软件测试工程师,总经理助理、行政主管,品质工程师,总经理、副总经理、总监,机械设计工程师、质量管理员、项目管理,灯检,质量工程师
\t熟练SQL语言，熟练使用Oracle	java程序员,软件开发及相关的工作
PCB绘图	电力电子研发工程师
Microsoft office	给排水,软件测试,助理室内设计师
F5	网络工程师
Realflow，Vue	栏目包装
PDMS	管道助理工程师
单片机编程	研发部担当硬件工程师
数据库操作	网络工程师
3DMAX	设计师,室内设计师助理,影视后期制作,动画师,项目经理,交互设计师
Web Develop-PHP	网站管理,产品部经理,项目经理,服务经理,实施工程师,软件工程师,技术经理,总经理,Project Manager,技术总监
.net软件开发	软件工程师
Object-C	iOS软件开发
数据分析	产品运营,业务主管/经理助理,数据分析师
PTC Pro/ENGINEER	机械工程师,机械设计工程师,工程师助理,模具设计工程师,设备主管,管理培训生,Senior Mechanical Engineer,项目管理,机械设计,质量工程师
Office-Excel	Planner
Jquery	java软件工程师,前端工程师
Power Point	无,活动策划,人事专员
生物软件：MEGA、Clustx比对	分子生物学研究院
热处理	金相理化分析
OutLook2010	质量经理
计算机一级	汽车零部件有限公司
3D	产品经理,景观施工员,平面设计,品牌设计,工业设计师,微信微博营销
劳动法规	商标，著作权，专职律师
数据建模	数据分析
项目规划	行政人事部经理，产品经理，项目经理，总经理助理
嵌入式Linux	嵌入式软件工程师,驱动软件研发工程师,基带DSP开发工程师、嵌入式软件工程师、软件工程师
维护-电气	电气工程师,电气技术员
C4D	结构工程师
建龙	施工现场总负责
HTML	软件工程师,软件测试工程师,java软件工程师,php程序员,.net程序员,高级测试工程师,java开发,.NET程序员,JAVA程序员,普通文职
AfterEffects	影视后期
Web Develop-Java Script	软件工程师,java软件工程师,高级软件工程师,项目经理,java程序员,.net软件工程师,软件开发工程师,开发部,Java工程师,设备处设备维护
Acrobat	给排水工程师
MS PowerPoint	环境工程项目经理,投资总监，高级投资经理 ,英文翻译
3d	施工员,室内设计师,设计师助理,UI设计师
OFFICE办公软件	财务总监,电气工程师
dreamweaver8	会计
autoCAD	产品设计助理,电气工程师,景观设计助理
Sql server	测试主管
Axure rp	交互设计
Google Analytics	网站数据分析
office 2013	银行会计
基于Node.js的软件开发	产品经理、项目经理
TCP/IP协议	嵌入式软件工程师
web	PHP程序员
逻辑电路设计	fpga开发应用
Cadcentre PDMS (工厂设计管理系统)	化工
专业英语四级	摄影师助理,投资顾问
大客户销售	部门负责人，招商，销售，珠宝，电子商务,小额贷 金融 理财产品
全国计算机一级	人事专员,无,施工员实习生
公关事件管理	公关 记者 编辑 企划
全国CAD技能等级考试一级证书	机械设计及维护
Sql Server 2008	软件工程师
ITIL（服务管理）	IT经理
vbs	软件测试
word、excel、ppt	机械工程师
pcb绘图	电气工程师
美术设计	3D、设计师、广告设计、工业产品设计、电视包装、管理,阿拉伯语相关工作
Java Web开发	程序员，软件测试，软件实施
普通话	采购员，行政专员/助理，销售代表，客服专员/助理，人事助理,会计助理,店主,客户服务/开发及管理,销售主管
Operating Systems-Windows NT/2000/XP/2003	技术经理、技术部经理、网优部门经理、技术总监,企划经理、品牌主管、微博运营主管,教务长,外贸,外贸业务员,无,成本经理,助理,高级总账会计,高级软件工程师
Office Excel	活动执行,主管
office powerpoint	会计 ,生产组织管理
Ajax 	软件工程师
活动策划	豌豆工作室创办者,兼职,推广主办 特渠营销经理,传媒 行政 策划 培训,网络美工 广告设计,广告策划、广告创意、媒介专员、广告业务,市场总监
Project Planning	高级软件工程师 项目主管/经理
SMT	SMT设备工程师
SW6压力容器强度计算	化工机械
电子商务	导游/旅行顾问,总经理助理，团队管理，销售管理，企业管理，人事行政管理,电子商务-淘宝天猫运营,物流主管,人事专员  人事助理  行政助理
flash cs6	gui设计师
Windows系统	IT工程师
SSH框架 Ibatis框架	java软件工程师
ERP	业务跟单,生产经理,服装设计师,淘宝店长,包材管理,行政主管,总会计师,会计,行政专员,生产管理兼日语翻译
linux C++	C++软件工程师
CROE	液压助理工程师
FL	网页设计,网页设计师
管理	店长,天津利安达贵金属交易所,经理助理,生产计划  采购,副总,区域销售经理,楼面经理,客服/行政/人事/质监/助理/主管/经理,投资管理及风险控制,行政人事经理
Web Develop-ASP.NET(C#)	软件工程师,程序员,技术经理,项目经理,产品经理,软件开发工程师,SDET,首席架构师,部门经理,项目经理;技术总监;架构师;高级软件工程师
金蝶会计软件	统计员
c，java，j2ee	高级工程师
ppt word 	网络编辑
oracle数据库	系统工程师,数据库管理员,linux c/c++开发工程师,java软件开发工程师,C软件开发,软件实施,程序员
金融交易	总经理
CruiseControl	配置管理（SCM）
熟练使用Word/Excel/Power	项目管理、标准化专员、产品经理助理、产品数据管理工程师等相关工作
Excel, Word, Powerpo	总账会计
JSP	java程序员,java软件工程师,Java工程师,研发工程师,java工程师,软件工程师,软件测试,JAVA软件工程师,java软件工程师，软件测试员,javaEE软件工程师
样品/样本处理	生产主管
struts 等三大框架	java软件开发
ORCALE	C++工程师
FMS 服务器	督导
学生入学	英语教师
Memcache、Redis、Mongo	PHP
熟练运用office办公软件	评估助理
计算机技能：Windows, word, excel, powerpoint, Internet。	财务经理
Linux 主机	ORACLE DBA
JSP/Servlet	员工,JAVA软件开发工程师,java工程师
Visual Basic语言	自动化生产及测试工程师
软件测试技术	项目经理
Rational Rose 建模	项目经理
用友财务系统	担保项目经理
MVC	.NET软件工程师,.Net软件工程师,研发工程师、开发工程师、项目经理
tomcat应用服务器	项目经理
redis && memcache	PHP 工程师
Axure	产品助理,产品经理,交互设计师,全职
Powerpoint	招聘专员,网站美工,会计助理,财务助理,产品经理,测试工程师,法务经理,经理助理,事业部经理,采购担当
业务增长	电销专员
java,C++,	ios开发工程师
网络管理软件	IT总监 信息总监 技术总监 云计算产品总监
lightroom	平面设计/ 数码修调
QTP，LoadRunner	软件测试工程师
javaScript	服务器研发工程师,软件开发工程师,PHP软件工程师
内容管理	CEO、COO、总编辑
数据库	软件开发,嵌入式软件开发工程师,网络工程师,软件开发工程师,javaweb开发工程师,java研发工程师,android开发,Java工程师,软件实施工程师,C++软件工程师
WebLogic	java开发
项目工程	机械设计
Java 等	android
维修简单的电脑	KA卖场主管
QA & TEST-Mantis	应用工程师,软件测试
编程开发asp,汇编,ajax等	粉体工程师
熟练运用excel	数据分析
三层架构，MVC模式开发，抽象工厂	.net工程师
医疗卫生	策划翻译市场推广
JCL (Job Control Language)	软件工程师
phoposhop	淘宝客服
Microsoft Windows Desktop	工程师
调酒	销售经理
Visual FoxPro 6.0	会计
销售	销售经理,销售代表,区域经理,销售,实习生,业务员,业务代表,通信行业销售代表,电话销售主管,销售管理
高中数学教学	QA｜QC
Visual Studio 2005	软件工程师
水质分析	水质分析与或者处理
公文写作	档案管理员,Customer Service Representative
熟练使用	总经理
粤语	物流经理,人事行政助理/专员,客户关系管理、公关策划、政府关系专员,融资 银行 风险管理 财务,船务
中英文版本的MS Office办公软件	造价员
Design/Media-HTML	.Net  工程师,品牌运作总监,高级网页设计师,项目美工,视觉设计师,上色/修复员,产品总监,动画师，建模师，渲染师，视频制作,程序员
pl/sql 和sql	linux系统维护
ASP.NET开发	软件工程师
Oracle 数据库	嵌入式软件工程师
Adobe ImageReady	研发人员
能熟练运用Windows、Linux环境	技术支持
Sql Server2008	.net软件开发
MS SQL Server	项目经理
统计软件SPSS	人力资源
power point	机电安装造价工程师
管理政策	关务
Cisco网络系统	技术支持
Office Applications-MS Powerpoint	产品经理,人事专员,副总经理,英语翻译,会计,经理,机械工程师,人力资源专员,研发人员,人力资源
银行法规	教师，企业法律顾问，律师
销售类型	销售经理,销售主管、销售经理，区域经理,普通职员,所有,企业公司
法语	工程师,法语相关工作,主管/经理/总助,环境管理方面岗位,翻译,客户经理,法语翻译,Retail Operation Management Trainee,销售经理、总经理助理
教师资格证	职能部门,教师，翻译，行政，人力,教师，行政助理,辅导教师,人事/行政助理 编辑,英语教师,教师及管理,助理,英语或计算机教师,语文老师，少儿英语老师，报纸编辑，英语翻译，对外汉语教师
iOS开发	iOS开发工程师,高级软件工程师
基本的office相关技能	工程造价
cocos2d-x、Lua	游戏前端开发
zbrush	三维
HTML语言	测试工程师
创意策划	人力资源经理
Solidwork	产品设计
成本控制	采购；人力资源；培训；物流/仓储；行政/后勤,项目顾问
PROTUES	硬件工程师
服务器硬件系统管理架构	ERP实施顾问
渠道销售	采销经理/销售经理/采购经理/电商渠道经理,渠道销售\区域销售\销售
模拟电路	硬件工程师
熟悉AJAX、 JAVASCRIPT	JAVA开发
c语言 linux	嵌入式软件工程师
CAD制图软件	研究员,全职
国家英语三级证书	人事专员
熟悉Dreamweaver、PowerD	java软件工程师
Java编程语言	无
socket网络编程	嵌入式软件工程师,嵌入式工程师,软件开发
工作特长：钳工装配，液压，划线，下料，能看懂装配图，液压图，能使用手弧焊，气保焊，手动/自动氧割，弓锯床，带剧床，小立铣，摇臂钻,能开叉车,持有B2驾驶证件。 	钳工
数据提取, 转换, 和加载 (ETL)	java,ETL工程师，BI工程师，JAVA软件开发工程师,数据分析，数据仓库，ETL开发，软件测试
Shell	测试工程师
Plsql	java软件工程师
纳米技术	化学研发人员，节能研究员，专利代理人
C++,C	英语/软件,机械设计工程
ASP.Net	软件工程师
hadoop：hive、mahout	数据
订单管理	经理／主管
Struts 1	java 软件工程师
Omnipeek	软件测试
SPSS	数据分析,项目申报,用户研究,俄语,研究员,用户体验,数据分析师,销售,经营分析经理,市场营销
水处理	环境工程设计工程师
CNC（计算机数控系统）	机械工程师
C#语言	辅导员,需求分析师
视频软件	视频内容编辑类工作,培训主管
PRO/E 2001	副总经理
高级会计师	Director of Human Resources
Sybase PowerDesigner	技术总监 咨询顾问
数据库sql	产品经理/运营经理
.Net体系架构	助理软件工程师
JBPM	java软件开发工程师
喷墨、激光打印机的维修与维护、加粉与加墨	网络管理员
B2B 电子商务营销	外贸销售员/外贸主管,电子商务，网络营销
查看API	Android开发工程师
freedhand画图软件	规划和管理人员
flash	电气工程师,资深美术设计师,文员,游戏策划,web前台开发,电子商务 淘宝,网页设计,导游,交互设计师,网页设计师
multisim	硬件工程师,电气工程师
办公软件应用	文秘
质量管理体系	生产副总、厂长、制造总监、生产总监、质量总监,铸造工程师,业务产品主管
运营管理	产品经理/专员,绩效主管,投资经理,总裁助理/总经理助理,营销经理,运营经理兼区域市场经理,总经理、副总经理、运营总监、工厂厂长、管理审计总监、高级咨询员,产品经理，游戏运营，商务合作,物流担当,总经理
div+css	j2EE开发
石油和天然气	俄语翻译
安易财务软件	财务经理
HTML、DIV+CSS	软件工程师,网页设计
.net	软件工程师,java程序员,开发人员,程序员
AD域控制器，FTP服务	网络工程师
培训项目	贸易销售类，采购，咨询顾问类
公共/媒体关系	公关 策划
Informix	系统工程师,开发工程师,java开发、Android、web、互联网
系统编程/网络编程	C/C++软件工程师
外语教学	高级商务经理
局域网组建，安全维护，办公设备维护	硬件工程师
广联达预算软件	技术员
Xcode4.x	iOS开发工程师
三级数据库	证照专员
Adobe Flex	JAVA软件开发
DNS (域名系统)	automaction test tools developer
SPSS统计软件	数据分析
亲和力 	市场营销专员
vc++	软件工程师,软件开发工程师
sqlserver、oracle、mys	java软件工程师
Operating Systems-Windows 95/98	产品经理,总监,工程（项目）经理,店长,行政管理,Senior manager,财务经理,总经理助理,项目实施工程师,Finance Supervisor
机械工程	销售工程师
PC/Desktop	产品专员/技术支持
广联达图形和钢筋算量	项目总工
系统分析	项目经理 产品经理 咨询师 系统分析架构师
Sketch Up	景观设计助理
TOMCAT	IT经理,软件实施工程师
HTML、XML、JavaScript	JavaEE软件工程师及相关岗位
生产运营管理	总经理、副总经理,副总、厂长,总经理助理
CET	供应链见习主管
Database-Infomix	软件工程师,技术总监,中级程序员
英语水平认证	英文客服，编辑，翻译,翻译,媒介助理,credit and investigation,网站优化
SAP（ERP）	工艺工程师
VB编程	软件研发工程师,研发工程师
Informatica	高级BI顾问
Rhino(犀牛)	产品设计
数据恢复（高级）	计算机软硬件维护工程师
汇编	软件开发工程师,BIOS 工程师,C++软件工程师,通信技术工程师,硬件工程师,FPGA软件开发人员,嵌入式工程师
J2ee	Java程序员
linux操作系统	JAVA软件开发,硬件工程师,软件工程师,Linux嵌入式驱动工程师
MapInfo	软件产品经理,运营专员,质量工程师、数据处理工程师
能独立编写和执行测试用例	软件测试工程师
ADINA	机械设计工程师 机械加工工艺工程师
Oracle、mysql等数据库	java工程师
Windows Develop-Office	测试工程师,软件测试,客户经理,行政助理,海外业务部商务经理,助理工程师,办公室主任,工程师,售后部门经理,讲师/助教
教育方法	老师,俄语翻译 俄语笔译口译
Java服务器端库和框架	java软件工程师,java开发工程师,Java工程师,android软件工程师,项目工程师,ORACLE DBA,程序员
Windows Develop-Win32 API	软件研发工程师,Consultant,会计助理,技术总监、部门经理,研发部经理
Visual Basic	不限定工作类别,电气工程师/技术员,嵌入式软件工程师,机械工程师,非车险理赔
CSS	软件测试工程师,java软件工程师,软件工程师,前端开发工程师,.net软件工程师,JAVA软件工程师,北京百德福科技发展有限公司,网页设计/制作/美工,java软件开发工程师,JAVA开发工程师/程序员
Remedy	软件工程师
linux环境下高级编程	嵌入式开发
Excel、word等	工程管理
Dreamwaver8，Firework	项目投资
MS word	无
HTML+CSS+JAVASCRIPT	软件工程师
ERP软件	采购经理（偏工程采购与招投标采购）,财务模块实施专员
人力资源认证	人事主管,人事专员,人力资源管理实习生
Java Web	Java
税务	财务总监 财务经理 税务总监  ,培训师
主流网络设备，服务器，存储和vm安装调试	客服工程师
SOLIDWORKS	机械工程师,营运总监,技术主管,生产管理,Lean Manager,机械绘图设计
NVQ Level 2	客服
Office Applications-MS Project	项目经理,产品经理,副总经理,高级产品经理,供应链管理工程师,运作流程优化,电气专业工程师,实施顾问,管道质量管理(QA/QC工程师),销售管理
YACC (A Compiler Compiler)	软件开发工程师
CAD  photoshop 	建筑智能化工程师
AutoCAD， Flash	审计助理
专利信息分析系统	专利工程师
Autocad	机械工程师,家居产品设计
西门子plc200	电气技术员
Network-Ethernet	项目主管及高级软件工程师,网络工程师,财务副经理,软件工程师,湖北分公司经理,高级测试工程师,项目运维总监,项目售前售后工程师,嵌入式软件工程师,销售业务
Struts2、springMVC	JAV研发工程师
Office Software	Director managing
Project工期编排	土建工程师
Html & CSS	软件工程师
C++/CLI	游戏引擎开发
数据库设计和开发	软件工程师
rhino软件	设计师
Business-to-Consumer (B2C)电子商务软件	项目主管,部门经理、经理助理
flotherm	销售，讲师，咨询师
广联达工程造价软件	土建工程师
CCSP (Cisco Certified Security Professional)	服务器技术支持主管
熟练Android UI的五种常用布局	Android
WORD	土建工程师,品牌经理,电气工程师,技术员 ,会计,市场策划/品牌管理/人力资源管理/记者/编辑/行政类,产品主管
Auto CAD	汽车底盘工程师,客服非技术,设计员,园林景观设计师助理,光学工程师,chassis design&development,机械设计,机械设计工程师,市场总监,工艺工程师
hbase，hive，pig	hadoop工程师
开关电源设计	电子研发工程师,嵌入式软件工程师,Test Engeerning
Fireworks	设计助理,高级UI设计师
MS Excel	采购工程师,品牌专员、媒介、推广,Analyst,销售
C#程序开发高薪技术证书（职业技术技能证	技术员，程序员，网站美工，前台开发
JAVASCRIPT程序设计	软件开发工程师
淘宝直通车	淘宝运营
投资报告	投资经理
mybatis	J2EE软件工程师
UV/VIS（紫外可见光谱）	分析检测、生物分离、药品厌烦
ProE	品质管理,机械工程师,采购工程师
Linux 操作系统	软件测试工程师,软件工程师,Java工程师,数据库工程师,嵌入式软件工程师,android软件工程师,技术支持工程师,工程师,project manager ,网站SEO+网站编辑+网站运营
CORELDRAW	人力资源主管
GPON	高级软件工程师
.net开发	项目经理
注册内部审计师	内部审计 和 风险管理相关职位
shell	java程序员,软件开发工程师,驱动工程师,软件测试工程师
Linux驱动	嵌入式软件工程师,linux嵌入式驱动程序开发工程师,驱动工程师
Axure、PHP、AJAX、MySQL	产品经理
物流管理	实习员,运输管理员,物流，跟单，文员，客服,物流，仓储，电子商务,仓库管理,物流
财务软件及ERP	财务经理
软、硬件	部门经理
R	量化分析员,风险投资分析师,定量分析师 Quantitative Analyst,量化投资
BI/DW	数据挖掘
制造管理	厂长，经理，生产总监
Android技术	Java程序员
硬件设计	技术支持，项目负责人
CET-6，全国计算机二级	财务会计、营销、客服
商务拓展	市场运营经理,商务经理
建筑制图	施工员,市政施工员
装配设备	职员
SolidWorks	机械工程师,机械设计,工程师,技术员,经理助理,助理工程师,厂长、设备经理,机械设计工程师 产品工程师,机械设计工程师,设备维护
项目管理能力	CIO、IT经理、项目经理、咨询顾问
教育管理	教育培训
熟悉android平台下的XML和JSO	安卓研发工程师
软件配置管理工具SVN	软件测试工程师
HTML、CSS	数据分析,软件工程师
HTML CSS JavaScript	程序员
锐捷交换机及路由器的配置	网络管理/系统运维
熟练使用Office办公软件	技术员,活动执行
Microsoft Visual Basic for Applications (VBA)	银行、证券、投资,Senior QA Engineer,策略设计，量化分析师,金融 证券,量化研究相关,嵌入式软件工程师,电气工程师,vb软件工程师,人力资源助理,高级测试工程师/测试/QA/QE
bash shell mysql	python软件工程师
ob-c	项目组长
文献检索	工艺工程师
Verilog硬件描述语言	技术支持工程师,初级 嵌入式软件设计工程师；软件设计,FPGA设计工程师,软件测试 / 电子研发工程师,数字IC设计  FPGA
活动管理	市场推广开发、会务管理,实习生
CMMI	软件研发总监
Design/Media-FrontPage	酒店管理公司,质量管理员
药物分析	药品研发员
FreeHand	网页设计师
招聘/人事代理	助理猎头顾问,行政经理,国际战略采购部助理
熟练使用CAD绘图	给水排水工程设计
J2EE核心技术（jsp、ssh等）	java软件开发工程师
Photoshop 熟练	产品设计师
Office Powerpoint	财务
用户界面/体验 (UI/UE)	程序研发
asp.net	嵌入式软件工程师,技术助理,高级软件工程师
高级人力资源管理师	人事总监、人力资源经理．人力资源主管,人力资源经理
Microsoft Visual Studio 2005	软件工程师
Macromedia ActionScript	软件开发
并发编程	java研发工程师
表达/口头技能	总经理助理
Microsoft Visual Studio 2008	高级软件工程师
HIBERNAET	Java软件工程师
TCP/IP	软件工程师,嵌入式开发,嵌入式软件开发工程师,产品经理,软件测试工程师,程序员
JSP+Servlet+JavaBean	软件开发工程师
Java 2 Platform Enterprise Edition (J2EE)	软件工程师,java软件工程师,软件开发工程师,java软件开发工程师,高级软件工程师,java,java程序员,Java工程师,Java软件工程师,测试工程师,javaWeb工程师
C++	软件工程师,iOS开发工程师,软件测试,软件实施,资料员,自动化工程师,iOS高级软件工程师,ios开发工程师,C++软件工程师,电子工程师
Adobe CorelDraw	平面设计师
国际商务	营销经理&商务主管,国际贸易, 跟单员  店长
protel 99se 	单片机工程师
Fine Pitch SMT	企业运营管理
Microsoft Visio	产品经理,通信技术/设计工程师,技术支持,设备经理,交互设计
邮件处理	外贸业务员，外贸助理,Assistant to GM
售后	客户经理
CorelDraw	平面设计，室内设计,营销策划,IT管理员/网络管理员/系统管理员,用户体验&交互设计&品牌策划,平面设计,设计师助理,平面设计实习,设计师,项目助理,市场营销
Database-Oracle	软件工程师,高级软件工程师,项目经理,java软件工程师,技术总监,软件开发工程师,运维工程师,技术支持工程师,产品经理,测试工程师
Apple iWorks	市场总监/市场经理
POSIX	嵌入式软件工程师
\t熟练掌握基于DXP的PCB设计	嵌入式工程师
delphi	程序员
美术	美工设计,跟工作相关的
Winter 09/protel 99	生产管理/工艺管理
EXE	施工员
文档处理	助理/销售支持/发行
loadrunner	软件测试工程师
ISO 9000	模具工程师,IE,PE,生产管理
ISO 9001	QA Test Center/ Project Manager,生产运作经理
SQLServer	JAVA开发工程师,市场稽核员,项目拓展规划设计,java软件工程师
熟练运用J2EE规范下的MVC设计	Java软件工程师
servlet, jdbc , Java	java开发工程师
熟练操作Microsoft office办公软件	会计
熟悉NTIER分层框架	.Net软件工程师
XML工具	软件测试工程师
计算机二级（VF）	财务会计/金融投资
.NET开发	.net程序员
TD-SCDMA	系统技术支持
Microsoft Windows XP	软件测试
VOIP系统	IT经理
全国计算机二级VF等级证书	费控
烹饪操作	行政总厨
电器设计	设备管理
网络技术知识	电脑房
cad pkpm	施工
Java测试	java软件工程师,程序员
熟练掌握Office 办公软件	自动控制工程师
Network-TCP\\/IP	软件工程师
Thrift	Java开发， 技术支持， 管培生
一级建造师	副总裁、总裁、总经理、副总经理,施工图设计师、项目主管
日语一级证书	日语翻译,翻译,日语翻译；人力资源管理；市场营销；销售助理；海外市场,日语翻译，日语业务员，日语跟单，文员，销售等,日语BPO专员,SAP及日语翻译,文书编辑、翻译，企划、人事助理,翻译 助理,日语翻译担当,日语助理
Excel、Powerpoint	景观设计师
犀牛	设计师
Ansys workbench	机械设计工程师
熟练使用Pro/e	模具设计师
电路测试	电气工程师,弱电工程师,硬件应用工程师
会计	会计,会计助理,会计文员,销售项目经理,财务经理,经理,审计助理,销售,财务部实习生,经理/部门主管/总监/店长
Windows office	结构
金蝶软件	审计助理,会计,会计主管
db2	java软件工程师
vision画图	行政助理
熟练运用Office系列办公软件。	软件工程师，网络的维护及测试，设备技术人员，人力资源类工作，策划类工作，助理类工作，装潢设计、通讯、
qt	嵌入式软件工程师,软件工程师
Windows Develop-C#	软件工程师,.net程序员,高级软件工程师,软件测试工程师,技术总监,项目经理,.net软件工程师,研发工程师,程序员,软件开发
sql server 2005	android软件工程师
熟悉Oracle，PL/SQL，Proc	C++软件工程师
Oracle DBA (数据库管理员)	数据库管理员,网络工程师或oracle数据库工程师,ORACLE DBA,oracle DBA及相关,数据库
Microsoft SQL Server	软件工程师,java软件工程师,程序员，软件工程师,ASP.NET程序员,风险管理，精算管理，投资咨询,高级软件工程师,JAVA软件开发,项目经理,测试工程师,数据库库管理员
springMVC	java工程师
以太网协议、交换机技术和socket编程	软件工程师
Linux的驱动开发	电子工程师（医疗电子）
制造/生产测试	销售助理
数据库设计	数据库开发,软件工程师,项目经理
Java软件开发	java软件工程师
金蝶财务软件	会计/审计,财务助理,财务经理/财务主管,国际业务代表,助理,财会相关工作,财务总监,行政助理,会计+ 财务管理 + 审计
C/C+	信号处理工程师
出纳	总经理助理
Ps	记者、编辑、文员
用友	会计,人力资源相关职位,财务会计,出纳
服装cad	服装设计助理
金蝶财务管理软件	财务经理
排版	文员/行政专员/助理,美编/平面设计/美工/编辑/策划/网站美工/网站编辑
计算机办公软件	会计
媒体投放	Social media
JavaScript、HTML、CSS	java软件工程师
Access+ASP	网络管理
计算机编程	电气工程师,单片机工程师，嵌入式工程师,软件工程师,管理培训生,研发人员,项目经理,技术支持及自动化、自动控制或测试、计算机相关,it 金融 教育 传媒,程序员
CRD	工业设计师   外观产品设计
Aspen plus	化工工艺设计师
CAXA	环卫专用车产品设计工程师,液压设计工程师,机械设计,技术员,工艺工程师（PE）
PR	平面设计
PS	室内设计师,动画师,ilunx系统管理员,美工,三维动画师,剪辑师,机械助理工程师,室内设计,助理规划师,维修工程师
5、起草、传达行政通知、相关文件或备忘录，协助组织公司各种活动和会议；  	行政专员/助理
Android平台UI设计	android开发工程师
熟练各种办公软件 	人事专员
数据库相关	机器人足球实验室软件研发
jquery,ajax,html,css	java软件工程师
verilog	IC验证工程师,研发工程师,数字芯片工程师
PL\SQL	ERP实施顾问
清华斯维尔	电气工程师
CISCO PIX 防火墙	全职
PM	软件测试工程师
液压设计	机械设计,储蓄干部/助理工程师
Datastream	金融，财务，投资，管理
GSM/WCDMA	移动通信技术
金蝶KIS	会计
专业工程师	土建工程师,研发工程师
PLC编程调试	电气工程师
java相关技术	java 高级研发 项目经理
Wind数据库应用	投资银行业务
技术支持	网络管理员,存储工程师,技术支持,汽轮机技术支持,销售服务部经理,产品总监 项目经理,电子工程师
MySql	java工程师,C/C++软件工程师,软件工程师,测试工程师,Java开发工程师
Word 2007	助理会计
PS、CD图片标量矢量设计软件	音效师
中级会计师	财务经理,会计,会计主管、财务主管,审计助理,财务,会计，财务，主办会计，财务主管，财务经理,财务主管,财审部主任/副总会计师,财务经理，会计经理，财务主管,审计经理
JAVA语言编程	软件测试实习生
机械制造	厂长,经理,机械工程师&技术销售,Sales management, customer service, business and marketing 
平面设计软件	设计师
c#/ASP.net	软件开发工程师
Microsoft Project	电气工程师,产品经理,产品工程师/项目工程师/制造工程师,策划,机械工程师、项目工程师,研发部主管,技术部经理,项目经理，需求分析，测试经理
驾照C	债权部主管
项目验收	售前技术支持工程师
Oracle数据库及其SQL语言的数据操	java开发工程师
服务器支持	软件测试工程师
DEC硬件	LED电子工程师
JavaScript/jQuery	php程序员
熟练使用SVN等版本控制工具	java程序员
二级	房产销售经理,电气工程师,Army Nuclear Division Assistant Engineer,硬件开发
ISO9000	水处理膜产品研发工程师
R-project	研究助理
MsWord	扫描电镜相关技术人员
VC++	应用工程师,研发工程师
Flash CS	家教老师,动画师,绘画、动画、影视、平面,实习生,审计助理,网站维护
Visual Basic 6	区域项目经理
编写报告	软件测试工程师、项目经理
精通JavaScript、MVC开发模式	.net程序员
系统管理	CIO,网络工程师,IT主管,质量部副经理 内训讲师
Database-Sybase	项目主管,产品经理,产品经理 售前,软件开发工程师,高级咨询顾问,工业节能,沈阳分公司总经理,管理岗,副总经理,测试工程师
html、css、javascript	软件开发
LINDO	市场分析
Ado.net	.net 软件工程师
VC++开发	电气工程师
Autcad	助理工程师
较为熟练的使用AutoCAD软件	设计工程师
ORACLE数据库	技术支持
熟悉Linux多进程（进程间通信）、多线	Linux c开发工程师
财务审计	会计、审计、金融,金融类、财务类、投资分析类职位,财务总监 财务顾问,咨询专员
PLSQL Developer、MyEc	java程序员
SQL 数据库	软件开发工程师
c#,asp	软件工程师
信号发生器	硬件测试工程师
图像处理和音频处理	医药代表
Microsoft 办公系列	业务类
Mathematica	软件测试或数据分析师
Data Guard	数据库工程师  系统工程师
熟练使用CAD制图	施工员、招投标专员、造价员
c#	java工程师,项目经理,测试工程师,游戏开发工程师,软件工程师,软件开发工程师,软件开发工程师 ,实施顾问,软件研发,自动化测试开发
Monolithic操作系统	生产经理
全国AUTOCAD高级证书	施工员
c	电子工程师,linux C开发工程师,高级软件工程师
SQLSERVER、ORACLE等数据库	软件工程师
财务用友ERP-NC软件	财务审计
掌握ajax、jquery框架	java软件开发工程师
Oracle,mySql	高级软件工程师
STATA	进口/关税，对外贸易部门,并购财务顾问（助理）
tomcat websphere等	高级软件工程师
Adobe Photoshop CS6	English & Japanese technical translator & interpreter
office-Powerpoint	数据挖掘工程师
学会与人沟通技巧；树立信心；向着目标坚定不移的前进 	兼职
越南语	外籍讲师,行政主管
办公	总经理
lucene、JavaMail、poi	java软件工程师
PHOTOSHOP	景观设计师,财务人员,网络工程师,空间设计,设计总监  资深设计师
Agile PLM (产品生命周期管理）	电子工程师
ios软件开发	iOS程序开发员
Sqlserver，mysql，orac	实施工程师
SSH2	java开发
PLC	电气工程师,电气技术员,机械工程师,设备工程师
Office办公	设计助理,java 软件工程师 程序员,品保工程师
CDR	淘宝美工,服装设计助理,平面设计师助理,动漫衍生设计师
全面质量管理 (TQM)	CHO,HRD,工程技术、质量管理、生产管理
ArcGIS 10软件	城市规划实习
Windows Develop-C	软件工程师,项目经理,嵌入式软件工程师,技术支持工程师,产品经理,电气工程师,软件开发工程师,研发工程师,软件测试工程师,硬件工程师
ＡＵＴＯ　ＣＡＤ	造价员
vb	java软件开发相关职业,java软件工程师
银行服务	理财分析师
展示/陈列设计	客户经理专员
Borland Delphi	软件研发工程师,delphi软件工程师，移动开发，IT企业销售，,android工程师
QC测试管理工具	软件测试工程师
常用Data Structure	Android开发工程师
hardware	土建工程师
电脑维修	硬件工程师,弱电项目经理
Protel99、Altium Desi	研发工程师
telecommunication (NUFM)	销售总监
PPt	阿语翻译
景观设计	景观设计师,景观设计师 教师 储备干部,设计总监 ,景观规划设计师,景观规划/设计师
1．出色的面试技巧；	人力资源部经理；人事行政经理；人力资源总监；人事行政总监
Wps Office	咨询热线客服
jQuery/jQuery UI	JAVA软件工程师
SOA	.net软件工程师
LAMP (Linux-Apache-MySQL-PHP/Perl)	软件工程师,嵌入式开发工程师，技术支持工程师，,软件工程师/,软件开发工程师，wp7开发工程师,技术总监,部门经理,系统软件维护工程师
CAD (计算机辅助设计)软件	机械工程师,电气工程师,室内设计师,机械设计师,设计师,施工员,实习生,工程管理，项目经理，造价师，工程师,电力设计师,生产工艺管理
iPhone SDK	iPhone软件工程师
HTML/CSS/DIV	前端研发
linux内核驱动开发	嵌入式软件工程师
LAMP、LNMP集群搭建	linux运维工程师
PPT	人事专员,资料员,活动策划,无,预算员,财务会计,财务经理,销售助理,数据统计与分析,设计师
招聘计划	人力资源助理
android	产品,java工程师,android软件工程师,Python,软件工程师,android开发工程师,java软件工程师,SMT助理工程师,android 程序员,科研人员
Th-Arch建筑设计	给排水设计
MS SQLSERVER	.net软件工程师
premiere	银行客户经理、柜员,企划宣传专员,销售管理,策划/文案
Sketch up	景观设计
3．熟悉存储过程(存储过程，游标，方法	java工程师
架构设计	项目经理
EViews	金融
分布式网络架构设计	运维经理
System-Linux	现场工程师
ERP-ACL	生产主管,银行信贷客户经理,海外分公司总经理,制造经理,生产管理兼品质管理,(副)总经理,客户经理,总经理,俄语翻译,品保经理
VHDL硬件描述语言	高级产品经理助理实习,初高中物理、英语教师
Midas	Structural Engineer
Tiptop	采购员
Jmeter	Team Leader, Software Tester,软件测试员
熟练操作使用SQLite等数据库	iOS工程师
Unix/Linux/BSD Devel-C#	软件工程师,售后服务技术员,c#   .net 开发,研发类,程序员
Oracle|	java
网络营销	美工设计
MS office	内控专员,人力资源专员；人事专员
C#编程语言	项目管理
Spring	java软件工程师,java开发工程师,Java工程师,项目经理,Java软件工程师,项目成员,软件工程师,java软件开发,开发工程师
会mastercam编程	机械设计工程师
熟悉HTML、XML、JavaScrip	Java软件工程师
熟练掌握主流的java 开发工具，如MyEclipse, eclipse等	java软件程序员
IBM DB2	外汇交易,软件测试工程师
Visual FoxPro	行政助理、专员 会计助理、出纳 ,人力资源助理,俄语教师或翻译,助理施工员,市场部
熟悉Oracle、sqlserver等	java程序员
仪器/仪表	电气技术员
全国计算机等级考试三级网络	java工程师
Groovy编程语言	测试经理 高级软件测试工程师
PowerPC	嵌入式软件工程师
Adobe Photoshop	机械设计工程师,设计师,机械工程师,翻译,产品经理,平面设计师,网站编辑,储备干部,交互设计,网页设计师
VxWorks	部门经理、项目经理、软件工程师,软件工程师
用友ERP	财务类,会计,人事主管/经理,财务经理
linix	软件工程师
Linux系统操作	软件工程师
人力资源管理	人事专员,人事助理,副总经理\行政总监\人力资源总监\书记,人力资源及行政经理,总经理助理，企业管理，战略管理,绩效薪酬专员,买手助理、管理培训生、奢侈品导购,总经理 副总经理 董事长助理 总经理助理 行政人事,行政/人事/人力资源总监,信息部部长
CROWDRAW	跟单员、单证员、船务、经理助理
Access	数据分析专员,数据分析,咨询顾问/数据分析师,会计
abap	abap
ExtJS、Jquery	Java软件工程师
Spring2.5	java程序员
语言学	翻译,实习生
OFFICE	建筑设计师,机械工程师,电气工程师,PDMS,技术部经理/生产部经理,模具设计师,公司客户经理,进口仪器销售及售后服务,软件工程师,无
助理物流师	人事助理,咨询顾问，物流与供应链管理，采购等职位
J2EE 开发经验	android 软件工程师
step7编程200/300	电气工程师
需求分析	Business Analyst,需求分析工程师,行业咨询师、顾问
会声会影	财务管理,银行柜员,客服,管理培训生,人事专员
Excel VBA	数据分析师
熟悉使用MFC 及windows  AP	软件工程师
网络互联	系统工程师
给排水设计	施工设计类职位,设计部,给排水
tcp/ip协议	嵌入式软件工程师
autform	Stamping Engineer
数控加工	物流专员,数控操作，设计，AUTICAD,UG.制图，加工中心
助理电子商务师（高级）	售前/售后客服
css3	前端
成本分析	会计经理
计算机二级C语言	物流经理,机械工程师,行业研究员
熟悉负载均衡	运维工程师
产品设计	工业设计,产品经理,产品设计,活动策划\渠道拓展,产品工程师,陶瓷设计师，产品外观设计师，包装设计师，平面设计师,工业设计师助理
熟练java语言,具备扎实的编程功底	JAVA工程师
商务谈判	英语教师,外贸业务,大客户经理,商务拓展,商务主管
Mysql，SQL Server	软件开发
javascript编程	市场推广
alutim design	测试工程师
驾驶证c1	影视后期剪辑/摄影摄像/导演助理/摄影摄像师助理/灯光师助理
C-- 汇编语言	销售工程师
icepak	热设计工程师
招生咨询	区域主管，市场助理，物流管理
产品管理	产品经理,售前 售后 技术支持 客服主管 产品经理
CISCO	网管
VC++,Java 	高级软件工程师、开发主管
人力资源分析	人力资源相关,Consulting,Management,Logistic
VSS ( Visual Source Safe )	软件工程师,软件测试工程师
熟练使用EXCEL，WORD等办公软件	会计、资金专员、风险管理、经营分析
Android 、Java程序设计	嵌入式工程师
Web编程	java软件开发工程师,java程序员
web开发	IOS开发设计
熟练使用PPT软件	行政经理
施工期管理	项目部技术员或者施工员,工程施工员
C/C++ LINUX	C/C++ 软件开发工程师
Revit Architecture	设计师
Office Applications-MS OneNote	审计员
oringe	市场分析/调研员
SQL	软件工程师,网络维护,软件实施,Java软件工程师,数据分析经理,.NET工程师,java工程师,C#高级软件工程师,软件测试,高级程序员
html+css+js、jQuery、A	java软件工程师
Office-Powerpoint	营销经理
PKPM	结构工程师
搜索引擎	销售工程师
熟悉Office办公软件	会计财务助理
javaWEB 和SSH框架	Java开发工程师
Stata等统计软件	经济及财务类
各类办公软件	锻造工程师,造价员
PDM数据库系统	新产品 质量品质工程师
食品研发	销售顾问
Microsoft PPT	品质工程师
驾照c本	人事经理
化学	化学教师
存储技术	系统集成项目经理
jsp/servlet/tomcat	软件工程师
研磨	研磨工,制图员
文案写作	销售助理 营销 公关,行政文秘,兼职文案,平面设计师,技术类人员,电子商务项目经理\淘宝店长\淘宝运营,文案策划 品牌专员 企划专员 市场助理
员工关系	培训经理/主管、人力资源经理/主管
电子商务支付系统	行政经理
Caxa	机械工程师
struts1/struts2	java软件工程师
熟练使用Eclipse、Myeclips	java程序员
VB.net	高级软件工程师，数据库管理员，数据库开发工程师，项目经理,工程师,初级软件工程师
Unix/Linux	软件测试工程师
kettle	数据分析
UG、Autoform	冲压工艺工程师
RoboHelp	技术文档工程师
有限元分析	mechaical engineer,兼职教师,机电一体化,机械工程师
保险销售	三亚二区的人力兼乐东营销服务部内勤负责人
UGNX绘图	管理，设计
UI设计	平面设计师  设计主管 淘宝平面设计师
财务软件	审计助理
word,excel,powerpoin	IOS开发工程师
磁共振成像 (MRI)	产品经理
dede织梦CMS二 次开发	php程序员
国家计算机2级	区域经理
高中教师资格证	海外学院教学部,高中教师
word  excel	预算员
WORD EXCEL	工程师
Dremweaver	UI设计
html、div、css	java软件开发工程师
Robot	测试总监
项目管理软件	项目经理
java技术	java开发工程师
Microsoft SQL Server 2000	软件开发工程师,软件工程师,网络运营总监,系统运维,软件测试工程师,SAP SalesConsulstant,售后客服,.net软件工程师,人事行政助理兼市场部助理,技术工程师
平面软件ps AI cd	产品设计师
熟悉oracle数据库	JAVA软件工程师
Microsoft SQL Server 2005	软件工程师,软件售前工程师,java软件工程师,C#软件工程师 .net程序员
SQL/Server/Oracle My	软件开发工程师
JDBC	软件工程师,软件测试工程师
C++，VC	软件研发工程师
IsaGraf的使用	Electrical engineer
SHS框架	java软件开发
零售销售	翻译
spring MVC	Java软件工程师
system-linux develop	产品经理
全国二级	汽车区域经理
UG	焊接工程师,模具设计师,焊装工艺员,机械设计师,无,专利代理人,品质工程师,机械工程师,白车身工程师,机械设计
powerpoint	会计,报关员,文员,会计助理,施工员,兼职教师,软件工程师,报检员,与日语有关的职位,IE工程师
专利申请	学生
掌握计算机组成原理，电脑DIY组装与维护	电子工程师
ms、ps	行政类、外贸类、董事长秘书
大学英语六级 	人事专员
javascript&jquery	软件工程师
ＩＳＯ内审员	产品经理、销售工程师
绘图软件	施工员,机械工程师,电气工程师,设计工程师,生产计划元
高级测量工	预算员
3Dmax	与包装有关的职业,景观设计师助理,后期 剪辑,设计总监/指导,市场企划部经理,橱窗设计,建筑设计助理,活动执行
计算机	出纳,技术支持工程师,外贸跟单、采购、市场策划,无,培训生,公关、公共事务、品牌,翻译，老师，外企,销售,生产计划主管,人力资源助理
计算机四级	行政人事
TCL编程	自动化工程师
视频编辑	财务
Rhinoceros	鞋产品设计师
零件检测与测绘；使用Catia进行零件设计与三维绘图，以及使用Caxa电子图版绘图	机械设计
办公软件（MS word, excel)	财务总监
预结算、招投标、安装算量	注册造价工程师
mysql/oracle	android手机应用开发
Word、Excel等	财务、会计、出纳
Ajax	java软件开发工程师,java程序员,软件工程师、项目经理,软件开发工程师
Unix/Linux/BSD Devel-C	嵌入式软件工程师,软件工程师,网站编辑,工程师,unix c 开发工程师,数字设计/验证工程师,供应商质量管理,高级测试经理,高级软件工程师,嵌入式linux工程师
实验室分析	生产助理
广告	外贸业务员 法语翻译
TIVOLi应用	项目主管
计算机系统安装	销售总监
基站	经理助理
图形处理	区域销售经理/业务经理
Web Develop-Python	软件工程师,信息部经理,产品经理,市场部专员,工艺研发工程师
jQuery easyui 	java软件工程师
flash开发	营销经理
思科	linux运维
内外网络组建、系统、软硬件维护	品控主管
软件设计与架构	软件经理
Java IDE (集成开发环境)	软件工程师,工程师,PHP Programmer,软件测试,java软件工程师,java初级工程师
memcache缓存	Web开发工程师
弱电（综合布线、安防、视频会议）安装调试	系统集成项目经理
Design/Media-3dStudio Max	三维动画,销售代表,建筑设计师,店面形象设计师,产品策划/产品专业,设计工程师+工艺工程师+pack工程师,工程副总,资深设计师,供应链主管/专员,软件测试
ExtJs	java高级软件工程师,android
项目管理专业人员资格认证(PMP)	项目经理,软件质量管理（SQA）,产品经理,测试经理, 项目经理,PMO/Portfolio/Program/Project Management,总裁/副总裁,采购经理,战略规划
财务报表	财务总监,财务主管,会计助理
Spring Struts Hibern	java工程师
Windows Develop-Visual Basic	软件工程师,嵌入式软件工程师,工程师,高级分析师,无,销售管理,经理助理,销售助理,生物，制药,财务经理,研发主管
Design/Media-rhino	工业设计师
CAD （计算机辅助设计和制图）	人力资源
精通计算机 	销售经理
系统集成各系统	系统集成销售部门经理
Gtk GUI (图形用户界面)工具包	软件工程师 软件测试
简单SQL和linux命令	软件测试工程师
幼儿教育	幼儿教师 小学教师,教师、培训师、人事行政类
预算员认证	预算员，施工员
QTP自动化工具	软件测试
英语	英语翻译,经理助理,总经理助理,会计助理,生产部经理助理,培训主管,质量经理、总监,电子商务,日语外贸,财务会计
DSP2000系列电机驱动程序开发	无
SPSS统计包	数据分析,综合类、职能类、咨询类,理财经理,人事专员 市场专员,全职,管理培训生,运营专员,人力资源管理/咨询/高管助理,行政专员,管理
Design/Media-Director	市场活动/推广专员
工具和模具制造	the mechnical
Dreamwaver	市场营销专员
html+css	Java工程师
峡光工程量清单计价软件	造价工程师
ASAP	光学工程师
microsoft word、excel、powerpoint	电气类
工程预算报价等文件处理	机电工程师
Proe三维制图	机械电子设计
熟悉linux 系统操作使用及命令行	软件测试
营销策略	 项目专员,区域经理 销售经理 销售,企业综合管理,蒙牛乳业（北京）有限责任公司,销售、市场,渠道经理、大区经理、市场部经理。,企划总监、营销总监,会计员
Macromedia Flash	 网站策划；网站营运经理/主管；市场/营销/拓展主管；产品/品牌主管；活动策划,产品经理
coredraw	工业设计师
三级数据库语言	电气工程师
DXP	动力环境监控工程师
AUTUCAD2013	机械设计工程师
objective-c	C++软件工程师,iOS开发工程师,高级软件工程师
基本数据存储方式	Android软件工程师
solidworks，proE	工程师助理
VisualBasic	产品研发
Juniper	网络工程师
金碟财务软件	会计主管
Hysys	石油化工技术支持工程师
photoshop图形处理	质量管理员
UG、Pro/E、Inventor、Au	研发工程师
Macromedia Dreamweaver	媒介专员;communication or media relevant,产品经理,SEM主管,法语编辑及翻译,广告投放；运营,网页/网站制作 美工,网站运营,移动交互设计,Android开发工程师；软件测试工程师,策划，执行，设计，网站，电子杂志
软件测试理论	软件测试
广联达计价软件	预算员,土建施工员
新闻写作	常务副总副、生产技术副总、质量副总、管理副总、行政副总,媒体
熟悉mvc开发模式	java开发工程师
DWR	高级软件工程师
熟练掌握opera系统	行政助理
办公外设（打印机与扫描仪）的管理与维护	网络管理员
JAVA EE	咨询 贸易 投资 
MFC ,win32	C++软件工程师
计算机操作	人事主管/人力资源主管/行政主管
精益制造	生产经理,制造经理或生管经理
Google Earth	旅游 策划
PHP,HTML,CSS	as3 flash工程师
CD	景观设计
Windowsxp7系统安装	软件实施
排版软件	企划部经理、市场部经理
linux开发	软件工程师,软件开发
ABAP开发	ABAP顾问
Linux系统及Linux下开发工具	嵌入式工程师
Web Develop-VB Script	主办会计,高等学院教师,结构工程师
tomcat	DBA,Java工程师,java软件程序员
WebService、Ajax编程	Java开发工程师
自动化系统	经理助理，技术助理
XCODE	软件工程师,iOS软件工程师
microcontroller C pr	工程师
photoshop，project等	土建工程师
数据库管理维护	信息部经理
视频音频剪辑	管理培训生
Linux 系统移植	嵌入式软件工程师
microsoft  office	人事行政经理
培训管理	人力资源助理,品质经理,物流经理（主管）
房产管理	个体户
